"date","state","positive","negative","pending","hospitalized","death","total","fips","deathIncrease","hospitalizedIncrease","negativeIncrease","positiveIncrease","totalTestResultsIncrease","NA.","positive1"
"2020-04-09","Alabama",14,6988,0,27,7,7223,7223,2,0,0,146,9,155,235
"2020-04-08","Alabama",14,6842,0,27,7,7068,7068,2,1,4,142,13,155,226
"2020-04-07","Alabama",14,6700,0,23,6,6913,6913,2,0,0,8,22,30,213
"2020-04-06","Alabama",13,6692,0,23,6,6883,6883,2,0,3,593,6,599,191
"2020-04-05","Alabama",13,6099,0,20,6,6284,6284,2,1,4,230,14,244,185
"2020-04-04","Alabama",13,5869,0,16,5,6040,6040,2,2,1,10,14,24,171
"2020-04-03","Alabama",13,5859,0,15,3,6016,6016,2,0,6,980,14,994,157
"2020-04-02","Alabama",12,4879,0,9,3,5022,5022,2,0,0,409,10,419,143
"2020-04-01","Alabama",12,4470,0,9,3,4603,4603,2,0,2,876,14,890,133
"2020-03-31","Alabama",12,3594,0,7,3,3713,3713,2,0,0,54,5,59,119
"2020-03-30","Alabama",12,3540,0,7,3,3654,3654,2,1,1,308,12,320,114
"2020-03-29","Alabama",12,3232,0,6,2,3334,3334,2,0,1,396,17,413,102
"2020-03-28","Alabama",10,2836,0,5,2,2921,2921,2,1,2,517,16,533,85
"2020-03-27","Alabama",8,2319,13,3,1,2401,2388,2,0,0,518,10,528,69
"2020-03-26","Alabama",7,1801,0,3,1,1860,1860,2,0,2,152,17,169,59
"2020-03-25","Alabama",6,1649,0,1,1,1691,1691,2,1,1,663,6,669,42
"2020-03-24","Alabama",5,986,0,0,0,1022,1022,2,0,0,40,14,54,36
"2020-03-23","Alabama",4,946,0,0,0,968,968,2,0,0,0,0,0,22
"2020-03-22","Alabama",4,946,0,0,0,968,968,2,0,0,188,8,196,22
"2020-03-21","Alabama",3,758,0,0,0,772,772,2,0,0,72,2,74,14
"2020-03-20","Alabama",3,686,0,0,0,698,698,2,0,0,254,6,260,12
"2020-03-19","Alabama",2,432,0,0,0,438,438,2,0,0,26,0,26,6
"2020-03-18","Alabama",2,406,0,0,0,412,412,2,0,0,72,3,75,6
"2020-03-17","Alabama",2,334,0,0,0,337,337,2,0,0,191,2,193,3
"2020-03-16","Alabama",2,143,0,0,0,144,144,2,0,0,0,0,0,1
"2020-03-15","Alabama",2,143,0,0,0,144,144,2,0,0,0,0,0,1
"2020-03-14","Alabama",2,143,0,0,0,144,144,2,0,0,84,0,84,1
"2020-03-13","Alabama",2,59,0,0,0,60,60,2,0,0,13,1,14,1
"2020-03-12","Alabama",2,46,14,0,0,60,46,2,0,0,0,0,0,0
"2020-03-11","Alabama",2,46,14,0,0,60,46,2,0,0,23,0,23,0
"2020-03-10","Alabama",2,23,9,0,0,32,23,2,0,0,0,0,0,0
"2020-03-09","Alabama",2,23,9,0,0,32,23,2,0,0,9,0,9,0
"2020-03-08","Alabama",2,14,6,0,0,20,14,2,0,0,2,0,2,0
"2020-03-07","Alabama",2,12,2,0,0,14,12,2,0,0,4,0,4,0
"2020-03-06","Alabama",2,8,1,0,0,9,8,2,0,0,0,0,0,0
"2020-03-05","Alabama",2,0,0,0,0,0,0,0,0,0,0,0,0,0
"2020-03-04","Alabama",2,0,0,0,0,0,0,0,0,0,0,0,0,0
"2020-03-03","Alabama",2,0,0,0,0,0,0,0,0,0,0,0,0,0
"2020-03-02","Alabama",2,0,0,0,0,0,0,0,0,0,0,0,0,0
"2020-03-01","Alabama",2,0,0,0,0,0,0,0,0,0,0,0,0,0
"2020-02-29","Alabama",2,0,0,0,0,0,0,0,0,0,0,0,0,0
"2020-02-28","Alabama",2,0,0,0,0,0,0,0,0,0,0,0,0,0
"2020-04-09","Alaska",37,18058,0,333,74,20827,20827,1,8,19,1305,400,1705,2769
"2020-04-08","Alaska",35,16753,0,314,66,19122,19122,1,10,43,3956,250,4206,2369
"2020-04-07","Alaska",34,12797,0,271,56,14916,14916,1,6,31,0,151,151,2119
"2020-04-06","Alaska",33,12797,0,240,50,14765,14765,1,5,9,1515,172,1687,1968
"2020-04-05","Alaska",33,11282,0,231,45,13078,13078,1,2,19,2009,216,2225,1796
"2020-04-04","Alaska",32,9273,0,212,43,10853,10853,1,8,212,1086,148,1234,1580
"2020-04-03","Alaska",31,8187,0,0,35,9619,9619,1,3,0,684,199,883,1432
"2020-04-02","Alaska",30,7503,0,0,32,8736,8736,1,6,0,806,156,962,1233
"2020-04-01","Alaska",30,6697,0,0,26,7774,7774,1,13,0,399,96,495,1077
"2020-03-31","Alaska",29,6298,0,0,13,7279,7279,1,7,0,604,122,726,981
"2020-03-30","Alaska",27,5694,0,0,6,6553,6553,1,2,0,1510,53,1563,859
"2020-03-29","Alaska",26,4184,0,0,4,4990,4990,1,1,0,0,110,110,806
"2020-03-28","Alaska",23,4184,0,0,3,4880,4880,1,0,0,0,109,109,696
"2020-03-27","Alaska",21,4184,0,0,3,4771,4771,1,2,0,591,81,672,587
"2020-03-26","Alaska",20,3593,0,0,1,4099,4099,1,1,0,1064,223,1287,506
"2020-03-25","Alaska",15,2529,0,0,0,2812,2812,1,0,0,423,68,491,283
"2020-03-24","Alaska",14,2106,0,0,0,2321,2321,1,0,0,441,48,489,215
"2020-03-23","Alaska",13,1665,0,0,0,1832,1832,1,0,0,201,29,230,167
"2020-03-22","Alaska",12,1464,0,0,0,1602,1602,1,0,0,1436,14,1450,138
"2020-03-21","Alaska",12,28,0,0,0,152,152,1,0,0,0,43,43,124
"2020-03-20","Alaska",10,28,0,0,0,109,109,1,0,0,0,13,13,81
"2020-03-19","Alaska",8,28,0,0,0,96,96,1,0,0,0,22,22,68
"2020-03-18","Alaska",6,28,0,0,0,74,74,1,0,0,0,10,10,46
"2020-03-17","Alaska",5,28,0,0,0,64,64,1,0,0,0,8,8,36
"2020-03-16","Alaska",4,28,40,0,0,96,56,1,0,0,0,16,16,28
"2020-03-15","Alaska",3,28,46,0,0,86,40,1,0,0,6,6,12,12
"2020-03-14","Alaska",2,22,46,0,0,74,28,1,0,0,11,5,16,6
"2020-03-13","Alaska",2,11,0,0,0,12,12,1,0,0,1,1,2,1
"2020-03-12","Alaska",2,10,0,0,0,10,10,1,0,0,0,0,0,0
"2020-03-11","Alaska",2,10,0,0,0,10,10,1,0,0,10,0,10,0
"2020-03-10","Alaska",2,0,0,0,0,0,0,1,0,0,0,0,0,0
"2020-03-09","Alaska",2,0,0,0,0,0,0,1,0,0,0,0,0,0
"2020-03-08","Alaska",2,0,0,0,0,0,0,1,0,0,0,0,0,0
"2020-03-07","Alaska",2,0,0,0,0,0,0,1,0,0,0,0,0,0
"2020-03-06","Alaska",2,0,0,0,0,0,0,0,0,0,0,0,0,0
"2020-03-05","Alaska",2,0,0,0,0,0,0,0,0,0,0,0,0,0
"2020-03-04","Alaska",2,0,0,0,0,0,0,0,0,0,0,0,0,0
"2020-03-03","Alaska",2,0,0,0,0,0,0,0,0,0,0,0,0,0
"2020-03-02","Alaska",2,0,0,0,0,0,0,0,0,0,0,0,0,0
"2020-03-01","Alaska",2,0,0,0,0,0,0,0,0,0,0,0,0,0
"2020-02-29","Alaska",2,0,0,0,0,0,0,0,0,0,0,0,0,0
"2020-02-28","Alaska",2,0,0,0,0,0,0,0,0,0,0,0,0,0
"2020-04-09","Arizona",38,34160,0,0,89,37178,37178,4,9,0,2322,292,2614,3018
"2020-04-08","Arizona",36,31838,0,0,80,34564,34564,4,7,0,1038,151,1189,2726
"2020-04-07","Arizona",36,30800,0,0,73,33375,33375,4,8,0,722,119,841,2575
"2020-04-06","Arizona",35,30078,0,0,65,32534,32534,4,1,0,4937,187,5124,2456
"2020-04-05","Arizona",35,25141,0,0,64,27410,27410,4,12,0,0,250,250,2269
"2020-04-04","Arizona",34,25141,0,0,52,27160,27160,4,11,0,2237,250,2487,2019
"2020-04-03","Arizona",33,22904,0,0,41,24673,24673,4,9,0,1793,171,1964,1769
"2020-04-02","Arizona",32,21111,0,0,32,22709,22709,4,3,0,1466,185,1651,1598
"2020-04-01","Arizona",31,19645,0,0,29,21058,21058,4,5,0,1563,124,1687,1413
"2020-03-31","Arizona",31,18082,0,0,24,19371,19371,4,4,0,2480,132,2612,1289
"2020-03-30","Arizona",30,15602,0,0,20,16759,16759,4,3,0,2649,238,2887,1157
"2020-03-29","Arizona",28,12953,0,0,17,13872,13872,4,2,0,5498,46,5544,919
"2020-03-28","Arizona",27,7455,21,0,15,8349,8328,4,2,0,0,137,137,873
"2020-03-27","Arizona",24,7455,30,0,13,8221,8191,4,5,0,7108,159,7267,736
"2020-03-26","Arizona",21,347,33,0,8,957,924,4,2,0,24,127,151,577
"2020-03-25","Arizona",19,323,53,0,6,826,773,4,1,0,10,93,103,450
"2020-03-24","Arizona",17,313,22,0,5,692,670,4,3,0,4,92,96,357
"2020-03-23","Arizona",15,309,6,0,2,580,574,4,0,0,27,113,140,265
"2020-03-22","Arizona",13,282,87,0,2,521,434,4,1,0,42,48,90,152
"2020-03-21","Arizona",12,240,122,0,1,466,344,4,1,0,29,39,68,104
"2020-03-20","Arizona",8,211,101,0,0,377,276,4,0,0,36,21,57,65
"2020-03-19","Arizona",6,175,130,0,0,349,219,4,0,0,27,16,43,44
"2020-03-18","Arizona",4,148,102,0,0,278,176,4,0,0,6,8,14,28
"2020-03-17","Arizona",4,142,66,0,0,228,162,4,0,0,17,2,19,20
"2020-03-16","Arizona",3,125,63,0,0,206,143,4,0,0,4,6,10,18
"2020-03-15","Arizona",3,121,50,0,0,183,133,4,0,0,0,0,0,12
"2020-03-14","Arizona",3,121,50,0,0,183,133,4,0,0,27,3,30,12
"2020-03-13","Arizona",2,94,40,0,0,143,103,4,0,0,12,0,12,9
"2020-03-12","Arizona",2,82,24,0,0,115,91,4,0,0,23,0,23,9
"2020-03-11","Arizona",2,59,32,0,0,100,68,4,0,0,8,3,11,9
"2020-03-10","Arizona",2,51,27,0,0,84,57,4,0,0,7,1,8,6
"2020-03-09","Arizona",2,44,7,0,0,56,49,4,0,0,0,0,0,5
"2020-03-08","Arizona",2,44,7,0,0,56,49,4,0,0,0,0,0,5
"2020-03-07","Arizona",2,44,7,0,0,56,49,4,0,0,11,2,13,5
"2020-03-06","Arizona",2,33,15,0,0,51,36,4,0,0,5,1,6,3
"2020-03-05","Arizona",2,28,6,0,0,36,30,4,0,0,1,0,1,2
"2020-03-04","Arizona",2,27,5,0,0,34,29,4,0,0,0,0,0,2
"2020-03-03","Arizona",2,0,0,0,0,0,0,0,0,0,0,0,0,0
"2020-03-02","Arizona",2,0,0,0,0,0,0,0,0,0,0,0,0,0
"2020-03-01","Arizona",2,0,0,0,0,0,0,0,0,0,0,0,0,0
"2020-02-29","Arizona",2,0,0,0,0,0,0,0,0,0,0,0,0,0
"2020-02-28","Arizona",2,0,0,0,0,0,0,0,0,0,0,0,0,0
"2020-04-09","Arkansas",30,13832,0,130,21,14951,14951,5,3,0,302,119,421,1119
"2020-04-08","Arkansas",30,13530,0,130,18,14530,14530,5,2,-18,838,54,892,1000
"2020-04-07","Arkansas",28,12692,0,148,16,13638,13638,5,0,11,722,71,793,946
"2020-04-06","Arkansas",27,11970,0,137,16,12845,12845,5,0,7,1558,45,1603,875
"2020-04-05","Arkansas",26,10412,0,130,16,11242,11242,5,2,24,785,87,872,830
"2020-04-04","Arkansas",24,9627,0,106,14,10370,10370,5,2,1,632,39,671,743
"2020-04-03","Arkansas",24,8995,0,105,12,9699,9699,5,0,5,1115,61,1176,704
"2020-04-02","Arkansas",22,7880,0,100,12,8523,8523,5,2,10,526,59,585,643
"2020-04-01","Arkansas",21,7354,0,90,10,7938,7938,5,2,90,1395,61,1456,584
"2020-03-31","Arkansas",20,5959,0,0,8,6482,6482,5,1,0,697,50,747,523
"2020-03-30","Arkansas",19,5262,0,0,7,5735,5735,5,1,0,2235,47,2282,473
"2020-03-29","Arkansas",18,3027,0,0,6,3453,3453,5,1,0,89,22,111,426
"2020-03-28","Arkansas",18,2938,0,0,5,3342,3342,5,2,0,1393,23,1416,404
"2020-03-27","Arkansas",17,1545,0,0,3,1926,1926,5,0,0,41,46,87,381
"2020-03-26","Arkansas",16,1504,0,0,3,1839,1839,5,1,0,67,55,122,335
"2020-03-25","Arkansas",15,1437,0,0,2,1717,1717,5,2,0,490,62,552,280
"2020-03-24","Arkansas",14,947,0,0,0,1165,1165,5,0,0,41,44,85,218
"2020-03-23","Arkansas",13,906,0,0,0,1080,1080,5,0,0,195,9,204,174
"2020-03-22","Arkansas",13,711,119,0,0,995,876,5,0,0,144,47,191,165
"2020-03-21","Arkansas",12,567,154,0,0,839,685,5,0,0,216,22,238,118
"2020-03-20","Arkansas",11,351,203,0,0,650,447,5,0,0,41,50,91,96
"2020-03-19","Arkansas",6,310,113,0,0,469,356,5,0,0,74,13,87,46
"2020-03-18","Arkansas",5,236,50,0,0,319,269,5,0,0,39,11,50,33
"2020-03-17","Arkansas",4,197,41,0,0,260,219,5,0,0,65,0,65,22
"2020-03-16","Arkansas",4,132,14,0,0,168,154,5,0,0,29,6,35,22
"2020-03-15","Arkansas",3,103,30,0,0,149,119,5,0,0,38,4,42,16
"2020-03-14","Arkansas",3,65,26,0,0,103,77,5,0,0,35,3,38,12
"2020-03-13","Arkansas",2,30,22,0,0,61,39,5,0,0,6,3,9,9
"2020-03-12","Arkansas",2,24,20,0,0,50,30,5,0,0,12,6,18,6
"2020-03-11","Arkansas",2,12,14,0,0,26,12,5,0,0,0,0,0,0
"2020-03-10","Arkansas",2,12,3,0,0,15,12,5,0,0,0,0,0,0
"2020-03-09","Arkansas",2,12,0,0,0,12,12,5,0,0,6,0,6,0
"2020-03-08","Arkansas",2,6,0,0,0,6,6,5,0,0,0,0,0,0
"2020-03-07","Arkansas",2,6,0,0,0,6,6,5,0,0,0,0,0,0
"2020-03-06","Arkansas",2,6,0,0,0,6,6,5,0,0,0,0,0,0
"2020-03-05","Arkansas",2,0,0,0,0,0,0,0,0,0,0,0,0,0
"2020-03-04","Arkansas",2,0,0,0,0,0,0,0,0,0,0,0,0,0
"2020-03-03","Arkansas",2,0,0,0,0,0,0,0,0,0,0,0,0,0
"2020-03-02","Arkansas",2,0,0,0,0,0,0,0,0,0,0,0,0,0
"2020-03-01","Arkansas",2,0,0,0,0,0,0,0,0,0,0,0,0,0
"2020-02-29","Arkansas",2,0,0,0,0,0,0,0,0,0,0,0,0,0
"2020-02-28","Arkansas",2,0,0,0,0,0,0,0,0,0,0,0,0,0
"2020-04-09","California",74,145191,14100,0,492,177600,163500,6,50,0,17884,1352,19236,18309
"2020-04-08","California",72,127307,14600,0,442,158864,144264,6,68,0,11943,1092,13035,16957
"2020-04-07","California",71,115364,14100,0,374,145329,131229,6,31,0,12269,1529,13798,15865
"2020-04-06","California",70,103095,15000,0,343,132431,117431,6,24,0,0,898,898,14336
"2020-04-05","California",69,103095,15000,0,319,131533,116533,6,43,0,1421,1412,2833,13438
"2020-04-04","California",68,101674,13000,0,276,126700,113700,6,39,0,77075,1325,78400,12026
"2020-04-03","California",66,24599,59500,0,237,94800,35300,6,34,0,790,1510,2300,10701
"2020-04-02","California",62,23809,59500,0,203,92500,33000,6,32,0,2037,1036,3073,9191
"2020-04-01","California",58,21772,57400,0,171,87327,29927,6,18,0,0,673,673,8155
"2020-03-31","California",55,21772,57400,0,153,86654,29254,6,20,0,1223,1035,2258,7482
"2020-03-30","California",51,20549,64400,0,133,91396,26996,6,10,0,0,739,739,6447
"2020-03-29","California",48,20549,64400,0,123,90657,26257,6,22,0,0,1065,1065,5708
"2020-03-28","California",44,20549,64400,0,101,89592,25192,6,23,0,3169,764,3933,4643
"2020-03-27","California",41,17380,57400,0,78,78659,21259,6,13,0,0,873,873,3879
"2020-03-26","California",38,17380,57400,0,65,77786,20386,6,12,0,1459,651,2110,3006
"2020-03-25","California",35,15921,48600,0,53,66876,18276,6,13,0,2469,253,2722,2355
"2020-03-24","California",34,13452,12100,0,40,27654,15554,6,13,0,885,369,1254,2102
"2020-03-23","California",32,12567,12100,0,27,26400,14300,6,0,0,1263,197,1460,1733
"2020-03-22","California",32,11304,0,0,27,12840,12840,6,3,0,55,257,312,1536
"2020-03-21","California",31,11249,0,0,24,12528,12528,6,4,0,825,216,1041,1279
"2020-03-20","California",30,10424,0,0,20,11487,11487,6,2,0,1637,139,1776,1063
"2020-03-19","California",28,8787,0,0,18,9711,9711,6,5,0,806,313,1119,924
"2020-03-18","California",22,7981,0,0,13,8592,8592,6,2,0,0,128,128,611
"2020-03-17","California",19,7981,0,0,11,8464,8464,6,5,0,0,148,148,483
"2020-03-16","California",16,7981,0,0,6,8316,8316,6,1,0,7065,42,7107,335
"2020-03-15","California",15,916,0,0,5,1209,1209,6,0,0,0,41,41,293
"2020-03-14","California",15,916,0,0,5,1168,1168,6,1,0,0,50,50,252
"2020-03-13","California",14,916,0,0,4,1118,1118,6,0,0,0,0,0,202
"2020-03-12","California",14,916,0,0,4,1118,1118,6,4,0,0,45,45,202
"2020-03-11","California",13,916,0,0,0,1073,1073,6,0,0,226,24,250,157
"2020-03-10","California",12,690,0,0,0,823,823,6,0,0,0,19,19,133
"2020-03-09","California",12,690,0,0,0,804,804,6,0,0,228,26,254,114
"2020-03-08","California",10,462,0,0,0,550,550,6,0,0,0,19,19,88
"2020-03-07","California",8,462,0,0,0,531,531,6,0,0,0,9,9,69
"2020-03-06","California",8,462,0,0,0,522,522,6,0,0,0,7,7,60
"2020-03-05","California",7,462,0,0,0,515,515,6,0,0,0,0,0,53
"2020-03-04","California",7,462,0,0,0,515,515,6,0,0,0,0,0,53
"2020-03-03","California",2,0,0,0,0,0,0,0,0,0,0,0,0,0
"2020-03-02","California",2,0,0,0,0,0,0,0,0,0,0,0,0,0
"2020-03-01","California",2,0,0,0,0,0,0,0,0,0,0,0,0,0
"2020-02-29","California",2,0,0,0,0,0,0,0,0,0,0,0,0,0
"2020-02-28","California",2,0,0,0,0,0,0,0,0,0,0,0,0,0
"2020-04-09","Colorado",48,23544,0,1162,193,29199,29199,8,14,83,879,226,1105,5655
"2020-04-08","Colorado",47,22665,0,1079,179,28094,28094,8,29,85,962,257,1219,5429
"2020-04-07","Colorado",46,21703,0,994,150,26875,26875,8,10,70,880,222,1102,5172
"2020-04-06","Colorado",45,20823,0,924,140,25773,25773,8,14,49,1488,385,1873,4950
"2020-04-05","Colorado",44,19335,0,875,126,23900,23900,8,15,52,1437,392,1829,4565
"2020-04-04","Colorado",42,17898,0,823,111,22071,22071,8,14,113,1215,445,1660,4173
"2020-04-03","Colorado",40,16683,0,710,97,20411,20411,8,17,90,1380,386,1766,3728
"2020-04-02","Colorado",39,15303,0,620,80,18645,18645,8,11,111,1420,376,1796,3342
"2020-04-01","Colorado",37,13883,0,509,69,16849,16849,8,18,95,1146,339,1485,2966
"2020-03-31","Colorado",36,12737,0,414,51,15364,15364,8,0,0,0,0,0,2627
"2020-03-30","Colorado",36,12737,0,414,51,15364,15364,8,7,140,1522,566,2088,2627
"2020-03-29","Colorado",34,11215,0,274,44,13276,13276,8,13,35,1273,327,1600,2061
"2020-03-28","Colorado",32,9942,0,239,31,11676,11676,8,7,55,1250,304,1554,1734
"2020-03-27","Colorado",31,8692,0,184,24,10122,10122,8,5,36,1714,344,2058,1430
"2020-03-26","Colorado",30,6978,0,148,19,8064,8064,8,8,64,189,174,363,1086
"2020-03-25","Colorado",28,6789,0,84,11,7701,7701,8,4,12,1285,192,1477,912
"2020-03-24","Colorado",24,5504,0,72,7,6224,6224,8,1,14,659,129,788,720
"2020-03-23","Colorado",21,4845,0,58,6,5436,5436,8,1,9,770,116,886,591
"2020-03-22","Colorado",19,4075,0,49,5,4550,4550,8,1,5,758,112,870,475
"2020-03-21","Colorado",17,3317,0,44,4,3680,3680,8,1,44,642,86,728,363
"2020-03-20","Colorado",15,2675,0,0,3,2952,2952,8,1,0,563,61,624,277
"2020-03-19","Colorado",14,2112,0,0,2,2328,2328,8,0,0,495,33,528,216
"2020-03-18","Colorado",13,1617,0,0,2,1800,1800,8,1,0,561,23,584,183
"2020-03-17","Colorado",13,1056,0,0,1,1216,1216,8,0,0,429,29,458,160
"2020-03-16","Colorado",12,627,0,0,1,758,758,8,0,0,0,0,0,131
"2020-03-15","Colorado",12,627,0,0,1,758,758,8,0,0,17,30,47,131
"2020-03-14","Colorado",12,610,0,0,1,711,711,8,1,0,86,29,115,101
"2020-03-13","Colorado",9,524,0,0,0,596,596,8,0,0,226,27,253,72
"2020-03-12","Colorado",6,298,0,0,0,343,343,8,0,0,47,17,64,45
"2020-03-11","Colorado",4,251,0,0,0,279,279,8,0,0,109,16,125,28
"2020-03-10","Colorado",3,142,1,0,0,155,154,8,0,0,9,3,12,12
"2020-03-09","Colorado",2,133,0,0,0,142,142,8,0,0,29,1,30,9
"2020-03-08","Colorado",2,104,0,0,0,112,112,8,0,0,49,0,49,8
"2020-03-07","Colorado",2,55,69,0,0,132,63,8,0,0,9,6,15,8
"2020-03-06","Colorado",2,46,30,0,0,78,48,8,0,0,27,2,29,2
"2020-03-05","Colorado",2,19,21,0,0,40,19,8,0,0,0,0,0,0
"2020-03-04","Colorado",2,0,0,0,0,0,0,0,0,0,0,0,0,0
"2020-03-03","Colorado",2,0,0,0,0,0,0,0,0,0,0,0,0,0
"2020-03-02","Colorado",2,0,0,0,0,0,0,0,0,0,0,0,0,0
"2020-03-01","Colorado",2,0,0,0,0,0,0,0,0,0,0,0,0,0
"2020-02-29","Colorado",2,0,0,0,0,0,0,0,0,0,0,0,0,0
"2020-02-28","Colorado",2,0,0,0,0,0,0,0,0,0,0,0,0,0
"2020-04-09","Connecticut",65,23718,0,0,380,33502,33502,9,103,0,2463,2003,4466,9784
"2020-04-08","Connecticut",57,21255,0,0,277,29036,29036,9,0,0,0,0,0,7781
"2020-04-07","Connecticut",57,21255,0,0,277,29036,29036,9,71,0,1475,875,2350,7781
"2020-04-06","Connecticut",53,19780,0,0,206,26686,26686,9,17,0,2185,1231,3416,6906
"2020-04-05","Connecticut",48,17595,0,0,189,23270,23270,9,24,0,842,399,1241,5675
"2020-04-04","Connecticut",47,16753,0,0,165,22029,22029,9,34,0,1652,362,2014,5276
"2020-04-03","Connecticut",45,15101,0,0,131,20015,20015,9,19,0,625,1090,1715,4914
"2020-04-02","Connecticut",41,14476,0,0,112,18300,18300,9,27,0,1433,267,1700,3824
"2020-04-01","Connecticut",40,13043,0,0,85,16600,16600,9,16,0,14,429,443,3557
"2020-03-31","Connecticut",38,13029,0,0,69,16157,16157,9,33,0,1000,557,1557,3128
"2020-03-30","Connecticut",36,12029,0,0,36,14600,14600,9,2,0,2122,578,2700,2571
"2020-03-29","Connecticut",33,9907,0,0,34,11900,11900,9,7,0,2798,702,3500,1993
"2020-03-28","Connecticut",31,7109,0,0,27,8400,8400,9,0,0,0,0,0,1291
"2020-03-27","Connecticut",31,7109,0,0,27,8400,8400,9,6,0,1484,279,1763,1291
"2020-03-26","Connecticut",30,5625,0,0,21,6637,6637,9,2,0,602,137,739,1012
"2020-03-25","Connecticut",27,5023,0,0,19,5898,5898,9,7,0,341,257,598,875
"2020-03-24","Connecticut",22,4682,0,0,12,5300,5300,9,2,0,597,203,800,618
"2020-03-23","Connecticut",18,4085,0,0,10,4500,4500,9,5,0,1208,192,1400,415
"2020-03-22","Connecticut",14,2877,0,0,5,3100,3100,9,1,0,771,29,800,223
"2020-03-21","Connecticut",13,2106,0,0,4,2300,2300,9,1,0,1502,0,1502,194
"2020-03-20","Connecticut",13,604,0,0,3,798,798,9,2,0,0,98,98,194
"2020-03-19","Connecticut",11,604,0,0,1,700,700,9,1,0,479,28,507,96
"2020-03-18","Connecticut",8,125,0,0,0,193,193,9,0,0,0,27,27,68
"2020-03-17","Connecticut",6,125,0,0,0,166,166,9,0,0,0,15,15,41
"2020-03-16","Connecticut",4,125,0,0,0,151,151,9,0,0,0,6,6,26
"2020-03-15","Connecticut",4,125,0,0,0,145,145,9,0,0,0,9,9,20
"2020-03-14","Connecticut",3,125,0,0,0,136,136,9,0,0,26,5,31,11
"2020-03-13","Connecticut",2,99,0,0,0,105,105,9,0,0,10,0,10,6
"2020-03-12","Connecticut",2,89,0,0,0,95,95,9,0,0,18,3,21,6
"2020-03-11","Connecticut",2,71,0,0,0,74,74,9,0,0,17,1,18,3
"2020-03-10","Connecticut",2,54,0,0,0,56,56,9,0,0,8,1,9,2
"2020-03-09","Connecticut",2,46,0,0,0,47,47,9,0,0,17,0,17,1
"2020-03-08","Connecticut",2,29,8,0,0,38,30,9,0,0,29,1,30,1
"2020-03-07","Connecticut",2,0,0,0,0,0,0,9,0,0,0,0,0,0
"2020-03-06","Connecticut",2,0,0,0,0,0,0,0,0,0,0,0,0,0
"2020-03-05","Connecticut",2,0,0,0,0,0,0,0,0,0,0,0,0,0
"2020-03-04","Connecticut",2,0,0,0,0,0,0,0,0,0,0,0,0,0
"2020-03-03","Connecticut",2,0,0,0,0,0,0,0,0,0,0,0,0,0
"2020-03-02","Connecticut",2,0,0,0,0,0,0,0,0,0,0,0,0,0
"2020-03-01","Connecticut",2,0,0,0,0,0,0,0,0,0,0,0,0,0
"2020-02-29","Connecticut",2,0,0,0,0,0,0,0,0,0,0,0,0,0
"2020-02-28","Connecticut",2,0,0,0,0,0,0,0,0,0,0,0,0,0
"2020-04-09","Delaware",30,8683,0,0,23,9890,9890,10,7,0,1055,279,1334,1207
"2020-04-08","Delaware",28,7628,0,0,16,8556,8556,10,0,0,0,0,0,928
"2020-04-07","Delaware",28,7628,0,0,16,8556,8556,10,2,0,1307,255,1562,928
"2020-04-06","Delaware",23,6321,0,0,14,6994,6994,10,0,0,0,0,0,673
"2020-04-05","Delaware",23,6321,0,0,14,6994,6994,10,0,0,447,80,527,673
"2020-04-04","Delaware",21,5874,0,0,14,6467,6467,10,0,0,879,143,1022,593
"2020-04-03","Delaware",19,4995,0,0,14,5445,5445,10,2,0,429,57,486,450
"2020-04-02","Delaware",17,4566,0,0,12,4959,4959,10,1,0,551,25,576,393
"2020-04-01","Delaware",17,4015,0,0,11,4383,4383,10,1,0,319,49,368,368
"2020-03-31","Delaware",16,3696,0,0,10,4015,4015,10,4,0,1480,55,1535,319
"2020-03-30","Delaware",15,2216,0,0,6,2480,2480,10,0,0,2180,32,2212,264
"2020-03-29","Delaware",14,36,0,0,6,268,268,10,3,0,0,18,18,232
"2020-03-28","Delaware",14,36,0,0,3,250,250,10,1,0,0,51,51,214
"2020-03-27","Delaware",13,36,0,0,2,199,199,10,1,0,0,33,33,163
"2020-03-26","Delaware",12,36,0,0,1,166,166,10,1,0,0,15,15,130
"2020-03-25","Delaware",12,36,0,0,0,151,151,10,0,0,0,24,24,115
"2020-03-24","Delaware",11,36,0,0,0,127,127,10,0,0,0,23,23,91
"2020-03-23","Delaware",8,36,0,0,0,104,104,10,0,0,0,12,12,68
"2020-03-22","Delaware",7,36,0,0,0,92,92,10,0,0,0,11,11,56
"2020-03-21","Delaware",6,36,0,0,0,81,81,10,0,0,0,7,7,45
"2020-03-20","Delaware",5,36,0,0,0,74,74,10,0,0,0,8,8,38
"2020-03-19","Delaware",5,36,0,0,0,66,66,10,0,0,0,5,5,30
"2020-03-18","Delaware",4,36,0,0,0,61,61,10,0,0,0,9,9,25
"2020-03-17","Delaware",3,36,0,0,0,52,52,10,0,0,0,8,8,16
"2020-03-16","Delaware",2,36,32,0,0,76,44,10,0,0,0,2,2,8
"2020-03-15","Delaware",2,36,32,0,0,74,42,10,0,0,0,0,0,6
"2020-03-14","Delaware",2,36,32,0,0,74,42,10,0,0,6,2,8,6
"2020-03-13","Delaware",2,30,10,0,0,44,34,10,0,0,7,0,7,4
"2020-03-12","Delaware",2,23,14,0,0,41,27,10,0,0,6,3,9,4
"2020-03-11","Delaware",2,17,2,0,0,20,18,10,0,0,0,1,1,1
"2020-03-10","Delaware",2,17,3,0,0,20,17,10,0,0,2,0,2,0
"2020-03-09","Delaware",2,15,3,0,0,18,15,10,0,0,5,0,5,0
"2020-03-08","Delaware",2,10,0,0,0,10,10,10,0,0,0,0,0,0
"2020-03-07","Delaware",2,10,0,0,0,10,10,10,0,0,0,0,0,0
"2020-03-06","Delaware",2,10,0,0,0,10,10,10,0,0,0,0,0,0
"2020-03-05","Delaware",2,0,0,0,0,0,0,0,0,0,0,0,0,0
"2020-03-04","Delaware",2,0,0,0,0,0,0,0,0,0,0,0,0,0
"2020-03-03","Delaware",2,0,0,0,0,0,0,0,0,0,0,0,0,0
"2020-03-02","Delaware",2,0,0,0,0,0,0,0,0,0,0,0,0,0
"2020-03-01","Delaware",2,0,0,0,0,0,0,0,0,0,0,0,0,0
"2020-02-29","Delaware",2,0,0,0,0,0,0,0,0,0,0,0,0,0
"2020-02-28","Delaware",2,0,0,0,0,0,0,0,0,0,0,0,0,0
"2020-04-09","District of Columbia",32,7201,0,0,32,8724,8724,11,5,0,358,83,441,1523
"2020-04-08","District of Columbia",31,6843,0,0,27,8283,8283,11,5,0,231,229,460,1440
"2020-04-07","District of Columbia",30,6612,0,0,22,7823,7823,11,-2,0,256,114,370,1211
"2020-04-06","District of Columbia",30,6356,0,0,24,7453,7453,11,2,0,520,99,619,1097
"2020-04-05","District of Columbia",29,5836,0,0,22,6834,6834,11,1,0,300,96,396,998
"2020-04-04","District of Columbia",28,5536,0,0,21,6438,6438,11,6,0,709,145,854,902
"2020-04-03","District of Columbia",25,4827,0,0,15,5584,5584,11,3,0,410,104,514,757
"2020-04-02","District of Columbia",23,4417,0,0,12,5070,5070,11,1,0,1155,67,1222,653
"2020-04-01","District of Columbia",21,3262,2,0,11,3850,3848,11,2,0,0,91,91,586
"2020-03-31","District of Columbia",19,3262,2,0,9,3759,3757,11,0,0,580,94,674,495
"2020-03-30","District of Columbia",18,2682,2,0,9,3085,3083,11,4,0,213,59,272,401
"2020-03-29","District of Columbia",16,2469,1,0,5,2812,2811,11,1,0,258,38,296,342
"2020-03-28","District of Columbia",16,2211,1,0,4,2516,2515,11,1,0,314,37,351,304
"2020-03-27","District of Columbia",15,1897,2,0,3,2166,2164,11,0,0,271,36,307,267
"2020-03-26","District of Columbia",14,1626,1,0,3,1858,1857,11,1,0,203,48,251,231
"2020-03-25","District of Columbia",13,1423,3,0,2,1609,1606,11,0,0,228,46,274,183
"2020-03-24","District of Columbia",12,1195,2,0,2,1334,1332,11,0,0,82,21,103,137
"2020-03-23","District of Columbia",12,1113,0,0,2,1229,1229,11,1,0,156,18,174,116
"2020-03-22","District of Columbia",11,957,0,0,1,1055,1055,11,0,0,451,21,472,98
"2020-03-21","District of Columbia",9,506,0,0,1,583,583,11,0,0,5,6,11,77
"2020-03-20","District of Columbia",9,501,1,0,1,573,572,11,1,0,348,32,380,71
"2020-03-19","District of Columbia",5,153,11,0,0,203,192,11,0,0,15,8,23,39
"2020-03-18","District of Columbia",5,138,1,0,0,170,169,11,0,0,34,9,43,31
"2020-03-17","District of Columbia",4,104,0,0,0,126,126,11,0,0,8,5,13,22
"2020-03-16","District of Columbia",3,96,7,0,0,120,113,11,0,0,17,1,18,17
"2020-03-15","District of Columbia",3,79,20,0,0,115,95,11,0,0,30,6,36,16
"2020-03-14","District of Columbia",3,49,10,0,0,69,59,11,0,0,29,0,29,10
"2020-03-13","District of Columbia",3,20,0,0,0,30,30,11,0,0,0,0,0,10
"2020-03-12","District of Columbia",3,20,0,0,0,30,30,11,0,0,0,5,5,10
"2020-03-11","District of Columbia",2,20,15,0,0,40,25,11,0,0,3,0,3,5
"2020-03-10","District of Columbia",2,17,2,0,0,24,22,11,0,0,3,4,7,5
"2020-03-09","District of Columbia",2,14,3,0,0,18,15,11,0,0,4,0,4,1
"2020-03-08","District of Columbia",2,10,0,0,0,11,11,11,0,0,2,1,3,1
"2020-03-07","District of Columbia",2,8,1,0,0,9,8,11,0,0,0,0,0,0
"2020-03-06","District of Columbia",2,8,1,0,0,9,8,11,0,0,2,0,2,0
"2020-03-05","District of Columbia",2,6,2,0,0,8,6,11,0,0,0,0,0,0
"2020-03-04","District of Columbia",2,0,0,0,0,0,0,0,0,0,0,0,0,0
"2020-03-03","District of Columbia",2,0,0,0,0,0,0,0,0,0,0,0,0,0
"2020-03-02","District of Columbia",2,0,0,0,0,0,0,0,0,0,0,0,0,0
"2020-03-01","District of Columbia",2,0,0,0,0,0,0,0,0,0,0,0,0,0
"2020-02-29","District of Columbia",2,0,0,0,0,0,0,0,0,0,0,0,0,0
"2020-02-28","District of Columbia",2,0,0,0,0,0,0,0,0,0,0,0,0,0
"2020-04-09","Florida",72,136185,1395,2268,354,153944,152549,12,45,206,8506,909,9415,16364
"2020-04-08","Florida",71,127679,1324,2062,309,144458,143134,12,13,63,4264,708,4972,15455
"2020-04-07","Florida",70,123415,1407,1999,296,139569,138162,12,60,317,13465,1423,14888,14747
"2020-04-06","Florida",69,109950,1142,1682,236,124416,123274,12,18,110,8697,1173,9870,13324
"2020-04-05","Florida",68,101253,1129,1572,218,114533,113404,12,27,110,10297,1040,11337,12151
"2020-04-04","Florida",67,90956,1281,1462,191,103348,102067,12,28,175,8819,1526,10345,11111
"2020-04-03","Florida",64,82137,1225,1287,163,92947,91722,12,35,164,12851,1575,14426,9585
"2020-04-02","Florida",58,69286,1285,1123,128,78581,77296,12,41,174,9757,1055,10812,8010
"2020-04-01","Florida",53,59529,1235,949,87,67719,66484,12,10,126,5244,617,5861,6955
"2020-03-31","Florida",51,54285,1163,823,77,61786,60623,12,14,171,6060,865,6925,6338
"2020-03-30","Florida",47,48225,0,652,63,53698,53698,12,7,58,9155,1227,10382,5473
"2020-03-29","Florida",42,39070,0,594,56,43316,43316,12,2,68,3704,483,4187,4246
"2020-03-28","Florida",41,35366,0,526,54,39129,39129,12,20,70,7180,998,8178,3763
"2020-03-27","Florida",37,28186,1517,456,34,32468,30951,12,6,50,4445,410,4855,2765
"2020-03-26","Florida",35,23741,1443,406,28,27539,26096,12,6,90,8367,673,9040,2355
"2020-03-25","Florida",32,15374,1233,316,22,18289,17056,12,4,57,2247,270,2517,1682
"2020-03-24","Florida",31,13127,1008,259,18,15547,14539,12,4,42,2064,241,2305,1412
"2020-03-23","Florida",30,11063,860,217,14,13094,12234,12,1,32,3073,341,3414,1171
"2020-03-22","Florida",26,7990,963,185,13,9783,8820,12,1,27,1411,172,1583,830
"2020-03-21","Florida",23,6579,1002,158,12,8239,7237,12,2,158,4709,138,4847,658
"2020-03-20","Florida",20,1870,1026,0,10,3416,2390,12,2,0,337,130,467,520
"2020-03-19","Florida",17,1533,1019,0,8,2942,1923,12,1,0,308,76,384,390
"2020-03-18","Florida",16,1225,954,0,7,2493,1539,12,1,0,285,128,413,314
"2020-03-17","Florida",13,940,872,0,6,1998,1126,12,2,0,256,45,301,186
"2020-03-16","Florida",12,684,514,0,4,1339,825,12,0,0,6,25,31,141
"2020-03-15","Florida",12,678,454,0,4,1248,794,12,1,0,200,39,239,116
"2020-03-14","Florida",9,478,221,0,3,776,555,12,1,0,0,27,27,77
"2020-03-13","Florida",7,478,221,0,2,749,528,12,0,0,177,18,195,50
"2020-03-12","Florida",5,301,147,0,2,480,333,12,0,0,0,4,4,32
"2020-03-11","Florida",4,301,147,0,2,476,329,12,2,0,79,9,88,28
"2020-03-10","Florida",3,222,155,0,0,396,241,12,0,0,82,1,83,19
"2020-03-09","Florida",3,140,115,0,0,273,158,12,0,0,22,1,23,18
"2020-03-08","Florida",3,118,108,0,0,243,135,12,0,0,18,3,21,17
"2020-03-07","Florida",3,100,88,0,0,202,114,12,0,0,45,5,50,14
"2020-03-06","Florida",2,55,51,0,0,115,64,12,0,0,24,0,24,9
"2020-03-05","Florida",2,31,69,0,0,109,40,12,0,0,7,7,14,9
"2020-03-04","Florida",2,24,16,0,0,42,26,12,0,0,0,0,0,2
"2020-03-03","Florida",2,0,0,0,0,0,0,0,0,0,0,0,0,0
"2020-03-02","Florida",2,0,0,0,0,0,0,0,0,0,0,0,0,0
"2020-03-01","Florida",2,0,0,0,0,0,0,0,0,0,0,0,0,0
"2020-02-29","Florida",2,0,0,0,0,0,0,0,0,0,0,0,0,0
"2020-02-28","Florida",2,0,0,0,0,0,0,0,0,0,0,0,0,0
"2020-04-09","Georgia",66,30519,0,2159,379,41085,41085,13,17,166,1633,665,2298,10566
"2020-04-08","Georgia",65,28886,0,1993,362,38787,38787,13,33,219,3991,1083,5074,9901
"2020-04-07","Georgia",61,24895,0,1774,329,33713,33713,13,100,442,935,1504,2439,8818
"2020-04-06","Georgia",55,23960,0,1332,229,31274,31274,13,18,49,2775,667,3442,7314
"2020-04-05","Georgia",52,21185,0,1283,211,27832,27832,13,10,44,1051,487,1538,6647
"2020-04-04","Georgia",50,20134,0,1239,201,26294,26294,13,17,81,700,329,1029,6160
"2020-04-03","Georgia",49,19434,0,1158,184,25265,25265,13,21,102,1825,483,2308,5831
"2020-04-02","Georgia",47,17609,0,1056,163,22957,22957,13,24,104,1921,710,2631,5348
"2020-04-01","Georgia",44,15688,0,952,139,20326,20326,13,28,119,3436,709,4145,4638
"2020-03-31","Georgia",41,12252,0,833,111,16181,16181,13,24,126,2337,1120,3457,3929
"2020-03-30","Georgia",37,9915,0,707,87,12724,12724,13,7,41,2,158,160,2809
"2020-03-29","Georgia",36,9913,0,666,80,12564,12564,13,11,49,1228,285,1513,2651
"2020-03-28","Georgia",35,8685,0,617,69,11051,11051,13,5,51,821,365,1186,2366
"2020-03-27","Georgia",34,7864,0,566,64,9865,9865,13,16,93,463,476,939,2001
"2020-03-26","Georgia",32,7401,0,473,48,8926,8926,13,8,79,2469,278,2747,1525
"2020-03-25","Georgia",30,4932,0,394,40,6179,6179,13,8,394,474,221,695,1247
"2020-03-24","Georgia",30,4458,0,0,32,5484,5484,13,7,0,161,254,415,1026
"2020-03-23","Georgia",25,4297,0,0,25,5069,5069,13,2,0,877,172,1049,772
"2020-03-22","Georgia",22,3420,0,0,23,4020,4020,13,9,0,863,93,956,600
"2020-03-21","Georgia",20,2557,0,0,14,3064,3064,13,1,0,591,87,678,507
"2020-03-20","Georgia",18,1966,0,0,13,2386,2386,13,3,0,422,133,555,420
"2020-03-19","Georgia",15,1544,0,0,10,1831,1831,13,9,0,233,90,323,287
"2020-03-18","Georgia",13,1311,0,0,1,1508,1508,13,0,0,1311,51,1362,197
"2020-03-17","Georgia",12,0,0,0,1,146,146,13,0,0,0,25,25,146
"2020-03-16","Georgia",12,0,0,0,1,121,121,13,0,0,0,22,22,121
"2020-03-15","Georgia",11,0,0,0,1,99,99,13,0,0,0,33,33,99
"2020-03-14","Georgia",8,0,0,0,1,66,66,13,0,0,0,24,24,66
"2020-03-13","Georgia",6,0,0,0,1,42,42,13,1,0,0,11,11,42
"2020-03-12","Georgia",5,0,0,0,0,31,31,13,0,0,0,9,9,31
"2020-03-11","Georgia",4,0,0,0,0,22,22,13,0,0,0,5,5,22
"2020-03-10","Georgia",3,0,0,0,0,17,17,13,0,0,0,5,5,17
"2020-03-09","Georgia",3,0,0,0,0,12,12,13,0,0,0,5,5,12
"2020-03-08","Georgia",2,0,0,0,0,7,7,13,0,0,0,1,1,7
"2020-03-07","Georgia",2,0,0,0,0,6,6,13,0,0,0,4,4,6
"2020-03-06","Georgia",2,0,0,0,0,2,2,13,0,0,0,0,0,2
"2020-03-05","Georgia",2,0,0,0,0,2,2,13,0,0,0,0,0,2
"2020-03-04","Georgia",2,0,0,0,0,2,2,13,0,0,0,0,0,2
"2020-03-03","Georgia",2,0,0,0,0,0,0,0,0,0,0,0,0,0
"2020-03-02","Georgia",2,0,0,0,0,0,0,0,0,0,0,0,0,0
"2020-03-01","Georgia",2,0,0,0,0,0,0,0,0,0,0,0,0,0
"2020-02-29","Georgia",2,0,0,0,0,0,0,0,0,0,0,0,0,0
"2020-02-28","Georgia",2,0,0,0,0,0,0,0,0,0,0,0,0,0
"2020-04-09","Hawaii",18,15316,0,42,5,15751,15751,15,0,0,577,25,602,435
"2020-04-08","Hawaii",18,14739,0,42,5,15149,15149,15,0,16,1584,23,1607,410
"2020-04-07","Hawaii",17,13155,0,26,5,13542,13542,15,1,5,0,16,16,387
"2020-04-06","Hawaii",17,13155,0,21,4,13526,13526,15,0,2,551,20,571,371
"2020-04-05","Hawaii",17,12604,0,19,4,12955,12955,15,1,1,645,32,677,351
"2020-04-04","Hawaii",16,11959,0,18,3,12278,12278,15,1,3,1753,34,1787,319
"2020-04-03","Hawaii",15,10206,0,15,2,10491,10491,15,1,0,0,27,27,285
"2020-04-02","Hawaii",15,10206,0,15,1,10464,10464,15,0,2,1485,50,1535,258
"2020-04-01","Hawaii",14,8721,0,13,1,8929,8929,15,1,1,250,4,254,208
"2020-03-31","Hawaii",14,8471,0,12,0,8675,8675,15,0,0,646,29,675,204
"2020-03-30","Hawaii",13,7825,0,12,0,8000,8000,15,0,0,976,24,1000,175
"2020-03-29","Hawaii",13,6849,0,12,0,7000,7000,15,0,4,2492,31,2523,151
"2020-03-28","Hawaii",12,4357,0,8,0,4477,4477,15,0,1,0,14,14,120
"2020-03-27","Hawaii",12,4357,0,7,0,4463,4463,15,0,2,0,11,11,106
"2020-03-26","Hawaii",11,4357,0,5,0,4452,4452,15,0,-1,0,5,5,95
"2020-03-25","Hawaii",11,4357,0,6,0,4447,4447,15,0,2,768,13,781,90
"2020-03-24","Hawaii",9,3589,0,4,0,3666,3666,15,0,4,634,21,655,77
"2020-03-23","Hawaii",7,2955,0,0,0,3011,3011,15,0,0,2692,8,2700,56
"2020-03-22","Hawaii",6,263,0,0,0,311,311,15,0,0,139,11,150,48
"2020-03-21","Hawaii",5,124,0,0,0,161,161,15,0,0,0,11,11,37
"2020-03-20","Hawaii",4,124,0,0,0,150,150,15,0,0,31,10,41,26
"2020-03-19","Hawaii",3,93,0,0,0,109,109,15,0,0,0,2,2,16
"2020-03-18","Hawaii",3,93,0,0,0,107,107,15,0,0,93,4,97,14
"2020-03-17","Hawaii",3,0,0,0,0,10,10,15,0,0,0,3,3,10
"2020-03-16","Hawaii",2,0,0,0,0,7,7,15,0,0,0,5,5,7
"2020-03-15","Hawaii",2,0,0,0,0,2,2,15,0,0,0,0,0,2
"2020-03-14","Hawaii",2,0,0,0,0,2,2,15,0,0,0,0,0,2
"2020-03-13","Hawaii",2,0,0,0,0,2,2,15,0,0,0,0,0,2
"2020-03-12","Hawaii",2,0,0,0,0,2,2,15,0,0,0,0,0,2
"2020-03-11","Hawaii",2,0,0,0,0,2,2,15,0,0,0,0,0,2
"2020-03-10","Hawaii",2,0,0,0,0,2,2,15,0,0,0,0,0,2
"2020-03-09","Hawaii",2,0,0,0,0,2,2,15,0,0,0,1,1,2
"2020-03-08","Hawaii",2,0,0,0,0,1,1,15,0,0,0,0,0,1
"2020-03-07","Hawaii",2,0,0,0,0,1,1,15,0,0,0,0,0,1
"2020-03-06","Hawaii",2,0,0,0,0,0,0,0,0,0,0,0,0,0
"2020-03-05","Hawaii",2,0,0,0,0,0,0,0,0,0,0,0,0,0
"2020-03-04","Hawaii",2,0,0,0,0,0,0,0,0,0,0,0,0,0
"2020-03-03","Hawaii",2,0,0,0,0,0,0,0,0,0,0,0,0,0
"2020-03-02","Hawaii",2,0,0,0,0,0,0,0,0,0,0,0,0,0
"2020-03-01","Hawaii",2,0,0,0,0,0,0,0,0,0,0,0,0,0
"2020-02-29","Hawaii",2,0,0,0,0,0,0,0,0,0,0,0,0,0
"2020-02-28","Hawaii",2,0,0,0,0,0,0,0,0,0,0,0,0,0
"2020-04-09","Idaho",30,11299,0,113,18,12531,12531,16,3,20,611,22,633,1232
"2020-04-08","Idaho",30,10688,0,93,15,11898,11898,16,2,10,612,40,652,1210
"2020-04-07","Idaho",30,10076,0,83,13,11246,11246,16,3,6,182,69,251,1170
"2020-04-06","Idaho",30,9894,0,77,10,10995,10995,16,0,11,710,24,734,1101
"2020-04-05","Idaho",30,9184,0,66,10,10261,10261,16,0,4,1327,64,1391,1077
"2020-04-04","Idaho",30,7857,0,62,10,8870,8870,16,1,6,803,122,925,1013
"2020-04-03","Idaho",27,7054,0,56,9,7945,7945,16,0,7,441,222,663,891
"2020-04-02","Idaho",23,6613,0,49,9,7282,7282,16,0,3,537,144,681,669
"2020-04-01","Idaho",20,6076,0,46,9,6601,6601,16,2,1,779,110,889,525
"2020-03-31","Idaho",18,5297,0,45,7,5712,5712,16,1,6,901,105,1006,415
"2020-03-30","Idaho",16,4396,0,39,6,4706,4706,16,1,3,375,49,424,310
"2020-03-29","Idaho",15,4021,0,36,5,4282,4282,16,1,11,679,31,710,261
"2020-03-28","Idaho",14,3342,0,25,4,3572,3572,16,1,25,674,41,715,230
"2020-03-27","Idaho",13,2668,0,0,3,2857,2857,16,3,0,603,66,669,189
"2020-03-26","Idaho",12,2065,0,0,0,2188,2188,16,0,0,178,50,228,123
"2020-03-25","Idaho",9,1887,0,0,0,1960,1960,16,0,0,0,23,23,73
"2020-03-24","Idaho",7,1887,0,0,0,1937,1937,16,0,0,578,3,581,50
"2020-03-23","Idaho",6,1309,0,0,0,1356,1356,16,0,0,134,5,139,47
"2020-03-22","Idaho",6,1175,0,0,0,1217,1217,16,0,0,295,11,306,42
"2020-03-21","Idaho",5,880,0,0,0,911,911,16,0,0,290,8,298,31
"2020-03-20","Idaho",4,590,0,0,0,613,613,16,0,0,131,12,143,23
"2020-03-19","Idaho",3,459,0,0,0,470,470,16,0,0,0,2,2,11
"2020-03-18","Idaho",2,459,0,0,0,468,468,16,0,0,113,2,115,9
"2020-03-17","Idaho",2,346,0,0,0,353,353,16,0,0,81,2,83,7
"2020-03-16","Idaho",2,265,0,0,0,270,270,16,0,0,91,0,91,5
"2020-03-15","Idaho",2,174,0,0,0,179,179,16,0,0,0,3,3,5
"2020-03-14","Idaho",2,174,0,0,0,176,176,16,0,0,43,2,45,2
"2020-03-13","Idaho",2,131,0,0,0,131,131,16,0,0,38,0,38,0
"2020-03-12","Idaho",2,93,0,0,0,93,93,16,0,0,26,0,26,0
"2020-03-11","Idaho",2,67,0,0,0,67,67,16,0,0,26,0,26,0
"2020-03-10","Idaho",2,41,0,0,0,41,41,16,0,0,0,0,0,0
"2020-03-09","Idaho",2,41,0,0,0,41,41,16,0,0,14,0,14,0
"2020-03-08","Idaho",2,27,0,0,0,27,27,16,0,0,0,0,0,0
"2020-03-07","Idaho",2,27,0,0,0,27,27,16,0,0,0,0,0,0
"2020-03-06","Idaho",2,0,0,0,0,0,0,0,0,0,0,0,0,0
"2020-03-05","Idaho",2,0,0,0,0,0,0,0,0,0,0,0,0,0
"2020-03-04","Idaho",2,0,0,0,0,0,0,0,0,0,0,0,0,0
"2020-03-03","Idaho",2,0,0,0,0,0,0,0,0,0,0,0,0,0
"2020-03-02","Idaho",2,0,0,0,0,0,0,0,0,0,0,0,0,0
"2020-03-01","Idaho",2,0,0,0,0,0,0,0,0,0,0,0,0,0
"2020-02-29","Idaho",2,0,0,0,0,0,0,0,0,0,0,0,0,0
"2020-02-28","Idaho",2,0,0,0,0,0,0,0,0,0,0,0,0,0
"2020-04-09","Illinois",72,64435,0,0,528,80857,80857,17,66,0,4447,1344,5791,16422
"2020-04-08","Illinois",71,59988,0,0,462,75066,75066,17,82,0,4805,1529,6334,15078
"2020-04-07","Illinois",69,55183,0,0,380,68732,68732,17,73,0,4503,1287,5790,13549
"2020-04-06","Illinois",68,50680,0,0,307,62942,62942,17,33,0,2953,1006,3959,12262
"2020-04-05","Illinois",67,47727,0,0,274,58983,58983,17,31,0,4503,899,5402,11256
"2020-04-04","Illinois",66,43224,0,0,243,53581,53581,17,33,0,4080,1453,5533,10357
"2020-04-03","Illinois",61,39144,0,0,210,48048,48048,17,53,0,3183,1209,4392,8904
"2020-04-02","Illinois",56,35961,0,0,157,43656,43656,17,16,0,2557,715,3272,7695
"2020-04-01","Illinois",53,33404,0,0,141,40384,40384,17,42,0,4173,986,5159,6980
"2020-03-31","Illinois",49,29231,0,0,99,35225,35225,17,26,0,3842,937,4779,5994
"2020-03-30","Illinois",46,25389,0,0,73,30446,30446,17,8,0,2223,461,2684,5057
"2020-03-29","Illinois",44,23166,0,0,65,27762,27762,17,18,0,1166,1105,2271,4596
"2020-03-28","Illinois",39,22000,0,0,47,25491,25491,17,13,0,3484,465,3949,3491
"2020-03-27","Illinois",38,18516,0,0,34,21542,21542,17,8,0,4423,488,4911,3026
"2020-03-26","Illinois",36,14093,0,0,26,16631,16631,17,7,0,1749,673,2422,2538
"2020-03-25","Illinois",33,12344,0,0,19,14209,14209,17,3,0,2410,330,2740,1865
"2020-03-24","Illinois",32,9934,0,0,16,11469,11469,17,4,0,1351,262,1613,1535
"2020-03-23","Illinois",31,8583,0,0,12,9856,9856,17,3,0,1312,224,1536,1273
"2020-03-22","Illinois",30,7271,0,0,9,8320,8320,17,3,0,1783,296,2079,1049
"2020-03-21","Illinois",25,5488,0,0,6,6241,6241,17,1,0,1792,168,1960,753
"2020-03-20","Illinois",21,3696,0,0,5,4281,4281,17,1,0,971,163,1134,585
"2020-03-19","Illinois",18,2725,0,0,4,3147,3147,17,3,0,962,134,1096,422
"2020-03-18","Illinois",15,1763,0,0,1,2051,2051,17,0,0,423,129,552,288
"2020-03-17","Illinois",13,1340,0,0,1,1499,1499,17,1,0,408,66,474,159
"2020-03-16","Illinois",11,932,0,0,0,1025,1025,17,0,0,483,29,512,93
"2020-03-15","Illinois",8,449,195,0,0,708,513,17,0,0,133,18,151,64
"2020-03-14","Illinois",6,316,82,0,0,444,362,17,0,0,22,14,36,46
"2020-03-13","Illinois",5,294,92,0,0,418,326,17,0,0,28,7,35,32
"2020-03-12","Illinois",4,266,76,0,0,367,291,17,0,0,22,6,28,25
"2020-03-11","Illinois",3,244,63,0,0,326,263,17,0,0,0,0,0,19
"2020-03-10","Illinois",3,244,63,0,0,326,263,17,0,0,53,12,65,19
"2020-03-09","Illinois",2,191,44,0,0,242,198,17,0,0,0,1,1,7
"2020-03-08","Illinois",2,191,44,0,0,241,197,17,0,0,0,0,0,6
"2020-03-07","Illinois",2,191,44,0,0,241,197,17,0,0,11,1,12,6
"2020-03-06","Illinois",2,180,35,0,0,220,185,17,0,0,15,0,15,5
"2020-03-05","Illinois",2,165,27,0,0,197,170,17,0,0,41,1,42,5
"2020-03-04","Illinois",2,124,27,0,0,155,128,17,0,0,0,0,0,4
"2020-03-03","Illinois",2,0,0,0,0,0,0,0,0,0,0,0,0,0
"2020-03-02","Illinois",2,0,0,0,0,0,0,0,0,0,0,0,0,0
"2020-03-01","Illinois",2,0,0,0,0,0,0,0,0,0,0,0,0,0
"2020-02-29","Illinois",2,0,0,0,0,0,0,0,0,0,0,0,0,0
"2020-02-28","Illinois",2,0,0,0,0,0,0,0,0,0,0,0,0,0
"2020-04-09","Indiana",51,25782,0,0,245,32133,32133,18,42,0,856,408,1264,6351
"2020-04-08","Indiana",49,24926,0,0,203,30869,30869,18,30,0,1669,436,2105,5943
"2020-04-07","Indiana",48,23257,0,0,173,28764,28764,18,34,0,2010,563,2573,5507
"2020-04-06","Indiana",45,21247,0,0,139,26191,26191,18,12,0,3006,533,3539,4944
"2020-04-05","Indiana",43,18241,0,0,127,22652,22652,18,11,0,2394,458,2852,4411
"2020-04-04","Indiana",41,15847,0,0,116,19800,19800,18,14,0,1449,516,1965,3953
"2020-04-03","Indiana",39,14398,0,0,102,17835,17835,18,24,0,1152,398,1550,3437
"2020-04-02","Indiana",38,13246,0,0,78,16285,16285,18,13,0,1436,474,1910,3039
"2020-04-01","Indiana",36,11810,0,0,65,14375,14375,18,16,0,596,406,1002,2565
"2020-03-31","Indiana",34,11214,0,0,49,13373,13373,18,14,0,1342,373,1715,2159
"2020-03-30","Indiana",33,9872,0,0,35,11658,11658,18,3,0,1556,272,1828,1786
"2020-03-29","Indiana",32,8316,0,0,32,9830,9830,18,1,0,1141,282,1423,1514
"2020-03-28","Indiana",30,7175,0,0,31,8407,8407,18,7,0,1220,251,1471,1232
"2020-03-27","Indiana",29,5955,0,0,24,6936,6936,18,7,0,1949,336,2285,981
"2020-03-26","Indiana",22,4006,0,0,17,4651,4651,18,3,0,1127,168,1295,645
"2020-03-25","Indiana",19,2879,0,1,14,3356,3356,18,2,0,313,112,425,477
"2020-03-24","Indiana",17,2566,0,1,12,2931,2931,18,5,0,865,106,971,365
"2020-03-23","Indiana",15,1701,0,1,7,1960,1960,18,1,0,408,58,466,259
"2020-03-22","Indiana",14,1293,0,1,6,1494,1494,18,2,0,586,75,661,201
"2020-03-21","Indiana",12,707,0,1,4,833,833,18,2,1,232,47,279,126
"2020-03-20","Indiana",9,475,0,0,2,554,554,18,0,0,151,23,174,79
"2020-03-19","Indiana",7,324,0,0,2,380,380,18,0,0,170,17,187,56
"2020-03-18","Indiana",5,154,0,0,2,193,193,18,0,0,25,9,34,39
"2020-03-17","Indiana",5,129,0,0,2,159,159,18,1,0,14,6,20,30
"2020-03-16","Indiana",4,115,0,0,1,139,139,18,1,0,13,5,18,24
"2020-03-15","Indiana",3,102,0,0,0,121,121,18,0,0,28,4,32,19
"2020-03-14","Indiana",3,74,0,0,0,89,89,18,0,0,13,3,16,15
"2020-03-13","Indiana",3,61,0,0,0,73,73,18,0,0,9,0,9,12
"2020-03-12","Indiana",3,52,0,0,0,64,64,18,0,0,19,2,21,12
"2020-03-11","Indiana",3,33,0,0,0,43,43,18,0,0,3,4,7,10
"2020-03-10","Indiana",2,30,0,0,0,36,36,18,0,0,30,4,34,6
"2020-03-09","Indiana",2,0,0,0,0,2,2,18,0,0,0,0,0,2
"2020-03-08","Indiana",2,0,0,0,0,2,2,18,0,0,0,1,1,2
"2020-03-07","Indiana",2,0,0,0,0,1,1,18,0,0,0,0,0,1
"2020-03-06","Indiana",2,0,0,0,0,1,1,18,0,0,0,0,0,1
"2020-03-05","Indiana",2,0,0,0,0,0,0,0,0,0,0,0,0,0
"2020-03-04","Indiana",2,0,0,0,0,0,0,0,0,0,0,0,0,0
"2020-03-03","Indiana",2,0,0,0,0,0,0,0,0,0,0,0,0,0
"2020-03-02","Indiana",2,0,0,0,0,0,0,0,0,0,0,0,0,0
"2020-03-01","Indiana",2,0,0,0,0,0,0,0,0,0,0,0,0,0
"2020-02-29","Indiana",2,0,0,0,0,0,0,0,0,0,0,0,0,0
"2020-02-28","Indiana",2,0,0,0,0,0,0,0,0,0,0,0,0,0
"2020-04-09","Iowa",31,13703,0,0,29,14973,14973,19,2,0,882,125,1007,1270
"2020-04-08","Iowa",30,12821,0,193,27,13966,13966,19,1,0,1151,97,1248,1145
"2020-04-07","Iowa",30,11670,0,193,26,12718,12718,19,1,14,1017,102,1119,1048
"2020-04-06","Iowa",28,10653,0,179,25,11599,11599,19,3,14,680,78,758,946
"2020-04-05","Iowa",27,9973,0,165,22,10841,10841,19,8,12,519,82,601,868
"2020-04-04","Iowa",25,9454,0,153,14,10240,10240,19,3,15,700,87,787,786
"2020-04-03","Iowa",23,8754,0,138,11,9453,9453,19,0,18,700,85,785,699
"2020-04-02","Iowa",22,8054,0,120,11,8668,8668,19,2,21,750,65,815,614
"2020-04-01","Iowa",20,7304,0,99,9,7853,7853,19,2,5,416,52,468,549
"2020-03-31","Iowa",19,6888,0,94,7,7385,7385,19,1,20,726,73,799,497
"2020-03-30","Iowa",18,6162,0,74,6,6586,6586,19,2,6,1149,88,1237,424
"2020-03-29","Iowa",16,5013,0,68,4,5349,5349,19,1,7,638,38,676,336
"2020-03-28","Iowa",15,4375,0,61,3,4673,4673,19,0,11,635,63,698,298
"2020-03-27","Iowa",14,3740,0,50,3,3975,3975,19,2,4,1162,56,1218,235
"2020-03-26","Iowa",13,2578,0,46,1,2757,2757,19,0,10,0,34,34,179
"2020-03-25","Iowa",12,2578,0,36,1,2723,2723,19,1,9,263,21,284,145
"2020-03-24","Iowa",12,2315,0,27,0,2439,2439,19,0,27,272,19,291,124
"2020-03-23","Iowa",12,2043,0,0,0,2148,2148,19,0,0,828,15,843,105
"2020-03-22","Iowa",11,1215,0,0,0,1305,1305,19,0,0,166,22,188,90
"2020-03-21","Iowa",8,1049,0,0,0,1117,1117,19,0,0,407,23,430,68
"2020-03-20","Iowa",6,642,0,0,0,687,687,19,0,0,559,7,566,45
"2020-03-19","Iowa",5,83,0,0,0,121,121,19,0,0,0,9,9,38
"2020-03-18","Iowa",4,83,0,0,0,112,112,19,0,0,0,6,6,29
"2020-03-17","Iowa",4,83,0,0,0,106,106,19,0,0,0,1,1,23
"2020-03-16","Iowa",4,83,0,0,0,105,105,19,0,0,0,4,4,22
"2020-03-15","Iowa",3,83,0,0,0,101,101,19,0,0,0,1,1,18
"2020-03-14","Iowa",3,83,0,0,0,100,100,19,0,0,0,1,1,17
"2020-03-13","Iowa",3,83,29,0,0,128,99,19,0,0,16,2,18,16
"2020-03-12","Iowa",3,67,24,0,0,105,81,19,0,0,21,1,22,14
"2020-03-11","Iowa",3,46,27,0,0,86,59,19,0,0,14,5,19,13
"2020-03-10","Iowa",2,32,11,0,0,51,40,19,0,0,6,5,11,8
"2020-03-09","Iowa",2,26,8,0,0,37,29,19,0,0,11,3,14,3
"2020-03-08","Iowa",2,15,2,0,0,17,15,19,0,0,0,0,0,0
"2020-03-07","Iowa",2,15,2,0,0,17,15,19,0,0,0,0,0,0
"2020-03-06","Iowa",2,15,2,0,0,17,15,19,0,0,0,0,0,0
"2020-03-05","Iowa",2,0,0,0,0,0,0,0,0,0,0,0,0,0
"2020-03-04","Iowa",2,0,0,0,0,0,0,0,0,0,0,0,0,0
"2020-03-03","Iowa",2,0,0,0,0,0,0,0,0,0,0,0,0,0
"2020-03-02","Iowa",2,0,0,0,0,0,0,0,0,0,0,0,0,0
"2020-03-01","Iowa",2,0,0,0,0,0,0,0,0,0,0,0,0,0
"2020-02-29","Iowa",2,0,0,0,0,0,0,0,0,0,0,0,0,0
"2020-02-28","Iowa",2,0,0,0,0,0,0,0,0,0,0,0,0,0
"2020-04-09","Kansas",30,9669,0,263,42,10775,10775,20,15,40,1055,206,1261,1106
"2020-04-08","Kansas",28,8614,0,223,27,9514,9514,20,0,0,0,0,0,900
"2020-04-07","Kansas",28,8614,0,223,27,9514,9514,20,2,25,375,55,430,900
"2020-04-06","Kansas",26,8239,0,198,25,9084,9084,20,3,15,763,98,861,845
"2020-04-05","Kansas",24,7476,0,183,22,8223,8223,20,1,11,596,49,645,747
"2020-04-04","Kansas",23,6880,0,172,21,7578,7578,20,4,21,426,78,504,698
"2020-04-03","Kansas",22,6454,0,151,17,7074,7074,20,4,13,395,68,463,620
"2020-04-02","Kansas",21,6059,0,138,13,6611,6611,20,3,24,648,70,718,552
"2020-04-01","Kansas",19,5411,0,114,10,5893,5893,20,1,35,415,54,469,482
"2020-03-31","Kansas",18,4996,0,79,9,5424,5424,20,1,13,442,60,502,428
"2020-03-30","Kansas",17,4554,0,66,8,4922,4922,20,2,11,360,49,409,368
"2020-03-29","Kansas",16,4194,0,55,6,4513,4513,20,1,28,523,58,581,319
"2020-03-28","Kansas",15,3671,0,27,5,3932,3932,20,1,0,442,59,501,261
"2020-03-27","Kansas",14,3229,0,27,4,3431,3431,20,1,27,360,34,394,202
"2020-03-26","Kansas",13,2869,0,0,3,3037,3037,20,0,0,509,42,551,168
"2020-03-25","Kansas",12,2360,0,0,3,2486,2486,20,1,0,274,28,302,126
"2020-03-24","Kansas",11,2086,0,0,2,2184,2184,20,0,0,1669,16,1685,98
"2020-03-23","Kansas",10,417,0,0,2,499,499,20,0,0,0,18,18,82
"2020-03-22","Kansas",8,417,0,0,2,481,481,20,0,0,0,9,9,64
"2020-03-21","Kansas",7,417,0,0,2,472,472,20,1,0,0,11,11,55
"2020-03-20","Kansas",6,417,0,0,1,461,461,20,0,0,0,10,10,44
"2020-03-19","Kansas",5,417,0,0,1,451,451,20,0,0,0,18,18,34
"2020-03-18","Kansas",3,417,0,0,1,433,433,20,0,0,35,1,36,16
"2020-03-17","Kansas",3,382,0,0,1,397,397,20,0,0,216,4,220,15
"2020-03-16","Kansas",3,166,0,0,1,177,177,20,0,0,31,3,34,11
"2020-03-15","Kansas",2,135,0,0,1,143,143,20,0,0,42,2,44,8
"2020-03-14","Kansas",2,93,0,0,1,99,99,20,1,0,0,0,0,6
"2020-03-13","Kansas",2,93,0,0,0,99,99,20,0,0,52,2,54,6
"2020-03-12","Kansas",2,41,0,0,0,45,45,20,0,0,0,3,3,4
"2020-03-11","Kansas",2,41,0,0,0,42,42,20,0,0,24,0,24,1
"2020-03-10","Kansas",2,17,21,0,0,39,18,20,0,0,6,0,6,1
"2020-03-09","Kansas",2,11,0,0,0,12,12,20,0,0,0,0,0,1
"2020-03-08","Kansas",2,11,0,0,0,12,12,20,0,0,0,1,1,1
"2020-03-07","Kansas",2,11,2,0,0,13,11,20,0,0,7,0,7,0
"2020-03-06","Kansas",2,4,0,0,0,4,4,20,0,0,0,0,0,0
"2020-03-05","Kansas",2,0,0,0,0,0,0,0,0,0,0,0,0,0
"2020-03-04","Kansas",2,0,0,0,0,0,0,0,0,0,0,0,0,0
"2020-03-03","Kansas",2,0,0,0,0,0,0,0,0,0,0,0,0,0
"2020-03-02","Kansas",2,0,0,0,0,0,0,0,0,0,0,0,0,0
"2020-03-01","Kansas",2,0,0,0,0,0,0,0,0,0,0,0,0,0
"2020-02-29","Kansas",2,0,0,0,0,0,0,0,0,0,0,0,0,0
"2020-02-28","Kansas",2,0,0,0,0,0,0,0,0,0,0,0,0,0
"2020-04-09","Kentucky",31,20455,0,0,73,21801,21801,21,8,0,0,197,197,1346
"2020-04-08","Kentucky",30,20455,0,0,65,21604,21604,21,6,0,1508,141,1649,1149
"2020-04-07","Kentucky",30,18947,0,0,59,19955,19955,21,14,0,1135,53,1188,1008
"2020-04-06","Kentucky",29,17812,0,0,45,18767,18767,21,5,0,2066,38,2104,955
"2020-04-05","Kentucky",28,15746,0,0,40,16663,16663,21,3,0,1005,86,1091,917
"2020-04-04","Kentucky",26,14741,0,0,37,15572,15572,21,6,0,2707,61,2768,831
"2020-04-03","Kentucky",25,12034,0,0,31,12804,12804,21,11,0,4814,90,4904,770
"2020-04-02","Kentucky",23,7220,0,0,20,7900,7900,21,3,0,255,89,344,680
"2020-04-01","Kentucky",21,6965,0,0,17,7556,7556,21,6,0,635,111,746,591
"2020-03-31","Kentucky",19,6330,0,0,11,6810,6810,21,2,0,751,41,792,480
"2020-03-30","Kentucky",18,5579,0,0,9,6018,6018,21,0,0,432,45,477,439
"2020-03-29","Kentucky",17,5147,0,0,9,5541,5541,21,1,0,326,92,418,394
"2020-03-28","Kentucky",16,4821,0,0,8,5123,5123,21,2,0,1053,54,1107,302
"2020-03-27","Kentucky",14,3768,0,0,6,4016,4016,21,2,0,666,50,716,248
"2020-03-26","Kentucky",13,3102,0,0,4,3300,3300,21,0,0,237,41,278,198
"2020-03-25","Kentucky",13,2865,0,0,4,3022,3022,21,0,0,1103,33,1136,157
"2020-03-24","Kentucky",12,1762,0,0,4,1886,1886,21,1,0,0,20,20,124
"2020-03-23","Kentucky",12,1762,0,0,3,1866,1866,21,0,0,290,5,295,104
"2020-03-22","Kentucky",11,1472,0,0,3,1571,1571,21,1,0,758,45,803,99
"2020-03-21","Kentucky",7,714,0,0,2,768,768,21,1,0,122,7,129,54
"2020-03-20","Kentucky",6,592,0,0,1,639,639,21,0,0,138,12,150,47
"2020-03-19","Kentucky",5,454,0,0,1,489,489,21,0,0,100,9,109,35
"2020-03-18","Kentucky",4,354,0,0,1,380,380,21,0,0,59,4,63,26
"2020-03-17","Kentucky",4,295,0,0,1,317,317,21,0,0,61,1,62,22
"2020-03-16","Kentucky",4,234,0,0,1,255,255,21,1,0,95,5,100,21
"2020-03-15","Kentucky",3,139,0,0,0,155,155,21,0,0,0,2,2,16
"2020-03-14","Kentucky",3,139,0,0,0,153,153,21,0,0,32,3,35,14
"2020-03-13","Kentucky",3,107,0,0,0,118,118,21,0,0,51,3,54,11
"2020-03-12","Kentucky",2,56,0,0,0,64,64,21,0,0,10,0,10,8
"2020-03-11","Kentucky",2,46,0,0,0,54,54,21,0,0,18,2,20,8
"2020-03-10","Kentucky",2,28,0,0,0,34,34,21,0,0,11,2,13,6
"2020-03-09","Kentucky",2,17,0,0,0,21,21,21,0,0,4,3,7,4
"2020-03-08","Kentucky",2,13,0,0,0,14,14,21,0,0,4,0,4,1
"2020-03-07","Kentucky",2,9,0,0,0,10,10,21,0,0,2,1,3,1
"2020-03-06","Kentucky",2,7,3,0,0,10,7,21,0,0,0,0,0,0
"2020-03-05","Kentucky",2,0,0,0,0,0,0,0,0,0,0,0,0,0
"2020-03-04","Kentucky",2,0,0,0,0,0,0,0,0,0,0,0,0,0
"2020-03-03","Kentucky",2,0,0,0,0,0,0,0,0,0,0,0,0,0
"2020-03-02","Kentucky",2,0,0,0,0,0,0,0,0,0,0,0,0,0
"2020-03-01","Kentucky",2,0,0,0,0,0,0,0,0,0,0,0,0,0
"2020-02-29","Kentucky",2,0,0,0,0,0,0,0,0,0,0,0,0,0
"2020-02-28","Kentucky",2,0,0,0,0,0,0,0,0,0,0,0,0,0
"2020-04-09","Louisiana",74,68636,0,0,702,86919,86919,22,50,0,4260,1253,5513,18283
"2020-04-08","Louisiana",73,64376,0,0,652,81406,81406,22,70,0,6005,746,6751,17030
"2020-04-07","Louisiana",72,58371,0,0,582,74655,74655,22,70,0,4072,1417,5489,16284
"2020-04-06","Louisiana",70,54299,0,0,512,69166,69166,22,35,0,6984,1857,8841,14867
"2020-04-05","Louisiana",69,47315,0,0,477,60325,60325,22,68,0,1313,514,1827,13010
"2020-04-04","Louisiana",68,46002,0,0,409,58498,58498,22,39,0,2654,2199,4853,12496
"2020-04-03","Louisiana",66,43348,0,0,370,53645,53645,22,60,0,1412,1147,2559,10297
"2020-04-02","Louisiana",62,41936,0,0,310,51086,51086,22,37,0,2584,2726,5310,9150
"2020-04-01","Louisiana",51,39352,0,0,273,45776,45776,22,34,0,5622,1187,6809,6424
"2020-03-31","Louisiana",46,33730,0,0,239,38967,38967,22,54,0,3722,1212,4934,5237
"2020-03-30","Louisiana",42,30008,0,0,185,34033,34033,22,34,0,5677,485,6162,4025
"2020-03-29","Louisiana",40,24331,0,0,151,27871,27871,22,14,0,2485,225,2710,3540
"2020-03-28","Louisiana",39,21846,0,0,137,25161,25161,22,18,0,3233,569,3802,3315
"2020-03-27","Louisiana",36,18613,0,0,119,21359,21359,22,36,0,2889,441,3330,2746
"2020-03-26","Louisiana",35,15724,0,0,83,18029,18029,22,18,0,6068,510,6578,2305
"2020-03-25","Louisiana",33,9656,0,0,65,11451,11451,22,19,0,2441,407,2848,1795
"2020-03-24","Louisiana",31,7215,0,0,46,8603,8603,22,12,0,2439,216,2655,1388
"2020-03-23","Louisiana",30,4776,0,0,34,5948,5948,22,14,0,2115,335,2450,1172
"2020-03-22","Louisiana",26,2661,0,0,20,3498,3498,22,4,0,481,252,733,837
"2020-03-21","Louisiana",21,2180,0,0,16,2765,2765,22,4,0,1612,106,1718,585
"2020-03-20","Louisiana",19,568,0,0,12,1047,1047,22,4,0,110,132,242,479
"2020-03-19","Louisiana",16,458,0,0,8,805,805,22,2,0,123,107,230,347
"2020-03-18","Louisiana",14,335,0,0,6,575,575,22,2,0,49,69,118,240
"2020-03-17","Louisiana",13,286,0,0,4,457,457,22,2,0,98,57,155,171
"2020-03-16","Louisiana",12,188,0,0,2,302,302,22,0,0,32,23,55,114
"2020-03-15","Louisiana",11,156,0,0,2,247,247,22,2,0,47,22,69,91
"2020-03-14","Louisiana",8,109,0,0,0,178,178,22,0,0,72,33,105,69
"2020-03-13","Louisiana",5,37,0,0,0,73,73,22,0,0,0,22,22,36
"2020-03-12","Louisiana",3,37,0,0,0,51,51,22,0,0,0,8,8,14
"2020-03-11","Louisiana",2,37,0,0,0,43,43,22,0,0,26,5,31,6
"2020-03-10","Louisiana",2,11,0,0,0,12,12,22,0,0,6,0,6,1
"2020-03-09","Louisiana",2,5,0,0,0,6,6,22,0,0,0,1,1,1
"2020-03-08","Louisiana",2,5,0,0,0,5,5,22,0,0,5,0,5,0
"2020-03-07","Louisiana",2,0,0,0,0,0,0,22,0,0,0,0,0,0
"2020-03-06","Louisiana",2,0,0,0,0,0,0,0,0,0,0,0,0,0
"2020-03-05","Louisiana",2,0,0,0,0,0,0,0,0,0,0,0,0,0
"2020-03-04","Louisiana",2,0,0,0,0,0,0,0,0,0,0,0,0,0
"2020-03-03","Louisiana",2,0,0,0,0,0,0,0,0,0,0,0,0,0
"2020-03-02","Louisiana",2,0,0,0,0,0,0,0,0,0,0,0,0,0
"2020-03-01","Louisiana",2,0,0,0,0,0,0,0,0,0,0,0,0,0
"2020-02-29","Louisiana",2,0,0,0,0,0,0,0,0,0,0,0,0,0
"2020-02-28","Louisiana",2,0,0,0,0,0,0,0,0,0,0,0,0,0
"2020-04-09","Maine",21,6088,0,105,16,6648,6648,23,2,4,0,23,23,560
"2020-04-08","Maine",20,6088,0,101,14,6625,6625,23,2,2,0,18,18,537
"2020-04-07","Maine",20,6088,0,99,12,6607,6607,23,2,7,0,20,20,519
"2020-04-06","Maine",19,6088,0,92,10,6587,6587,23,0,6,0,29,29,499
"2020-04-05","Maine",19,6088,0,86,10,6558,6558,23,0,3,0,14,14,470
"2020-04-04","Maine",19,6088,0,83,10,6544,6544,23,1,8,0,24,24,456
"2020-04-03","Maine",18,6088,0,75,9,6520,6520,23,2,7,0,56,56,432
"2020-04-02","Maine",17,6088,0,68,7,6464,6464,23,0,5,0,32,32,376
"2020-04-01","Maine",16,6088,0,63,7,6432,6432,23,2,6,0,41,41,344
"2020-03-31","Maine",16,6088,0,57,5,6391,6391,23,2,8,2694,28,2722,303
"2020-03-30","Maine",15,3394,0,49,3,3669,3669,23,0,49,0,22,22,275
"2020-03-29","Maine",15,3394,0,0,3,3647,3647,23,2,0,0,42,42,253
"2020-03-28","Maine",14,3394,0,0,1,3605,3605,23,0,0,0,43,43,211
"2020-03-27","Maine",13,3394,0,0,1,3562,3562,23,1,0,0,13,13,168
"2020-03-26","Maine",13,3394,0,0,0,3549,3549,23,0,0,217,6,223,155
"2020-03-25","Maine",12,3177,0,0,0,3326,3326,23,0,0,163,24,187,149
"2020-03-24","Maine",12,3014,0,0,0,3139,3139,23,0,0,223,18,241,125
"2020-03-23","Maine",12,2791,0,0,0,2898,2898,23,0,0,527,18,545,107
"2020-03-22","Maine",10,2264,0,0,0,2353,2353,23,0,0,0,16,16,89
"2020-03-21","Maine",9,2264,0,0,0,2337,2337,23,0,0,0,16,16,73
"2020-03-20","Maine",7,2264,0,0,0,2321,2321,23,0,0,260,4,264,57
"2020-03-19","Maine",7,2004,0,0,0,2057,2057,23,0,0,334,10,344,53
"2020-03-18","Maine",6,1670,0,0,0,1713,1713,23,0,0,367,11,378,43
"2020-03-17","Maine",5,1303,0,0,0,1335,1335,23,0,0,539,15,554,32
"2020-03-16","Maine",3,764,0,0,0,781,781,23,0,0,673,14,687,17
"2020-03-15","Maine",2,91,17,0,0,111,94,23,0,0,0,0,0,3
"2020-03-14","Maine",2,91,17,0,0,111,94,23,0,0,0,0,0,3
"2020-03-13","Maine",2,91,17,0,0,111,94,23,0,0,26,2,28,3
"2020-03-12","Maine",2,65,20,0,0,86,66,23,0,0,23,1,24,1
"2020-03-11","Maine",2,42,5,0,0,47,42,23,0,0,22,0,22,0
"2020-03-10","Maine",2,20,5,0,0,25,20,23,0,0,19,0,19,0
"2020-03-09","Maine",2,1,0,0,0,1,1,23,0,0,0,0,0,0
"2020-03-08","Maine",2,1,0,0,0,1,1,23,0,0,0,0,0,0
"2020-03-07","Maine",2,1,0,0,0,1,1,23,0,0,0,0,0,0
"2020-03-06","Maine",2,0,0,0,0,0,0,0,0,0,0,0,0,0
"2020-03-05","Maine",2,0,0,0,0,0,0,0,0,0,0,0,0,0
"2020-03-04","Maine",2,0,0,0,0,0,0,0,0,0,0,0,0,0
"2020-03-03","Maine",2,0,0,0,0,0,0,0,0,0,0,0,0,0
"2020-03-02","Maine",2,0,0,0,0,0,0,0,0,0,0,0,0,0
"2020-03-01","Maine",2,0,0,0,0,0,0,0,0,0,0,0,0,0
"2020-02-29","Maine",2,0,0,0,0,0,0,0,0,0,0,0,0,0
"2020-02-28","Maine",2,0,0,0,0,0,0,0,0,0,0,0,0,0
"2020-04-09","Maryland",50,35344,0,1348,138,41529,41529,24,14,138,2411,656,3067,6185
"2020-04-08","Maryland",48,32933,0,1210,124,38462,38462,24,21,104,5677,1158,6835,5529
"2020-04-07","Maryland",43,27256,0,1106,103,31627,31627,24,12,47,1684,326,2010,4371
"2020-04-06","Maryland",42,25572,0,1059,91,29617,29617,24,24,123,844,436,1280,4045
"2020-04-05","Maryland",40,24728,0,936,67,28337,28337,24,14,115,2243,484,2727,3609
"2020-04-04","Maryland",38,22485,0,821,53,25610,25610,24,11,157,1553,367,1920,3125
"2020-04-03","Maryland",37,20932,0,664,42,23690,23690,24,6,82,2042,427,2469,2758
"2020-04-02","Maryland",35,18890,0,582,36,21221,21221,24,5,60,1657,346,2003,2331
"2020-04-01","Maryland",33,17233,0,522,31,19218,19218,24,13,93,2365,325,2690,1985
"2020-03-31","Maryland",32,14868,0,429,18,16528,16528,24,3,76,1552,247,1799,1660
"2020-03-30","Maryland",31,13316,0,353,15,14729,14729,24,5,76,962,174,1136,1413
"2020-03-29","Maryland",30,12354,0,277,10,13593,13593,24,5,51,838,247,1085,1239
"2020-03-28","Maryland",29,11516,0,226,5,12508,12508,24,0,53,11422,218,11640,992
"2020-03-27","Maryland",25,94,0,173,5,868,868,24,1,41,0,194,194,774
"2020-03-26","Maryland",21,94,0,132,4,674,674,24,0,132,0,157,157,580
"2020-03-25","Maryland",18,94,0,0,4,517,517,24,1,0,0,74,74,423
"2020-03-24","Maryland",16,94,0,0,3,443,443,24,0,0,0,61,61,349
"2020-03-23","Maryland",15,94,0,0,3,382,382,24,0,0,0,44,44,288
"2020-03-22","Maryland",14,94,0,0,3,338,338,24,1,0,0,54,54,244
"2020-03-21","Maryland",13,94,0,0,2,284,284,24,1,0,0,41,41,190
"2020-03-20","Maryland",12,94,0,0,1,243,243,24,0,0,0,42,42,149
"2020-03-19","Maryland",12,94,0,0,1,201,201,24,1,0,0,22,22,107
"2020-03-18","Maryland",10,94,0,0,0,179,179,24,0,0,0,28,28,85
"2020-03-17","Maryland",7,94,0,0,0,151,151,24,0,0,0,20,20,57
"2020-03-16","Maryland",5,94,0,0,0,131,131,24,0,0,0,6,6,37
"2020-03-15","Maryland",5,94,0,0,0,125,125,24,0,0,0,5,5,31
"2020-03-14","Maryland",4,94,0,0,0,120,120,24,0,0,0,9,9,26
"2020-03-13","Maryland",3,94,0,0,0,111,111,24,0,0,0,5,5,17
"2020-03-12","Maryland",3,94,0,0,0,106,106,24,0,0,0,3,3,12
"2020-03-11","Maryland",2,94,0,0,0,103,103,24,0,0,5,3,8,9
"2020-03-10","Maryland",2,89,0,0,0,95,95,24,0,0,16,1,17,6
"2020-03-09","Maryland",2,73,0,0,0,78,78,24,0,0,21,2,23,5
"2020-03-08","Maryland",2,52,0,0,0,55,55,24,0,0,11,0,11,3
"2020-03-07","Maryland",2,41,0,0,0,44,44,24,0,0,15,0,15,3
"2020-03-06","Maryland",2,26,12,0,0,41,29,24,0,0,9,3,12,3
"2020-03-05","Maryland",2,17,14,0,0,31,17,24,0,0,0,0,0,0
"2020-03-04","Maryland",2,0,0,0,0,0,0,0,0,0,0,0,0,0
"2020-03-03","Maryland",2,0,0,0,0,0,0,0,0,0,0,0,0,0
"2020-03-02","Maryland",2,0,0,0,0,0,0,0,0,0,0,0,0,0
"2020-03-01","Maryland",2,0,0,0,0,0,0,0,0,0,0,0,0,0
"2020-02-29","Maryland",2,0,0,0,0,0,0,0,0,0,0,0,0,0
"2020-02-28","Maryland",2,0,0,0,0,0,0,0,0,0,0,0,0,0
"2020-04-09","Massachusetts",74,76017,0,1747,503,94958,94958,25,70,164,5296,2151,7447,18941
"2020-04-08","Massachusetts",72,70721,0,1583,433,87511,87511,25,77,148,4579,1588,6167,16790
"2020-04-07","Massachusetts",71,66142,0,1435,356,81344,81344,25,96,194,3550,1365,4915,15202
"2020-04-06","Massachusetts",69,62592,0,1241,260,76429,76429,25,29,96,3155,1337,4492,13837
"2020-04-05","Massachusetts",68,59437,0,1145,231,71937,71937,25,15,77,2373,764,3137,12500
"2020-04-04","Massachusetts",67,57064,0,1068,216,68800,68800,25,24,102,4504,1334,5838,11736
"2020-04-03","Massachusetts",66,52560,0,966,192,62962,62962,25,38,153,4918,1436,6354,10402
"2020-04-02","Massachusetts",61,47642,0,813,154,56608,56608,25,32,131,3642,1228,4870,8966
"2020-04-01","Massachusetts",56,44000,0,682,122,51738,51738,25,33,120,3685,1118,4803,7738
"2020-03-31","Massachusetts",52,40315,0,562,89,46935,46935,25,33,109,3274,868,4142,6620
"2020-03-30","Massachusetts",49,37041,0,453,56,42793,42793,25,8,54,2930,797,3727,5752
"2020-03-29","Massachusetts",45,34111,0,399,48,39066,39066,25,4,49,3319,698,4017,4955
"2020-03-28","Massachusetts",43,30792,0,350,44,35049,35049,25,9,131,4661,1017,5678,4257
"2020-03-27","Massachusetts",38,26131,0,219,35,29371,29371,25,10,0,4927,823,5750,3240
"2020-03-26","Massachusetts",35,21204,0,219,25,23621,23621,25,10,116,3248,579,3827,2417
"2020-03-25","Massachusetts",33,17956,0,103,15,19794,19794,25,4,9,5366,679,6045,1838
"2020-03-24","Massachusetts",30,12590,0,94,11,13749,13749,25,2,15,4445,382,4827,1159
"2020-03-23","Massachusetts",25,8145,0,79,9,8922,8922,25,4,8,2686,131,2817,777
"2020-03-22","Massachusetts",22,5459,0,71,5,6105,6105,25,4,10,707,121,828,646
"2020-03-21","Massachusetts",20,4752,0,61,1,5277,5277,25,0,61,1074,112,1186,525
"2020-03-20","Massachusetts",18,3678,0,0,1,4091,4091,25,1,0,874,85,959,413
"2020-03-19","Massachusetts",16,2804,0,0,0,3132,3132,25,0,0,789,72,861,328
"2020-03-18","Massachusetts",15,2015,0,0,0,2271,2271,25,0,0,474,38,512,256
"2020-03-17","Massachusetts",14,1541,0,0,0,1759,1759,25,0,0,1189,54,1243,218
"2020-03-16","Massachusetts",13,352,0,0,0,516,516,25,0,0,0,26,26,164
"2020-03-15","Massachusetts",12,352,0,0,0,490,490,25,0,0,0,0,0,138
"2020-03-14","Massachusetts",12,352,0,0,0,490,490,25,0,0,260,15,275,138
"2020-03-13","Massachusetts",12,92,0,0,0,215,215,25,0,0,92,28,120,123
"2020-03-12","Massachusetts",11,0,0,0,0,95,95,25,0,0,0,3,3,95
"2020-03-11","Massachusetts",11,0,0,0,0,92,92,25,0,0,0,0,0,92
"2020-03-10","Massachusetts",11,0,0,0,0,92,92,25,0,0,0,51,51,92
"2020-03-09","Massachusetts",6,0,0,0,0,41,41,25,0,0,0,28,28,41
"2020-03-08","Massachusetts",3,0,0,0,0,13,13,25,0,0,0,0,0,13
"2020-03-07","Massachusetts",3,0,0,0,0,13,13,25,0,0,0,5,5,13
"2020-03-06","Massachusetts",2,0,0,0,0,8,8,25,0,0,0,6,6,8
"2020-03-05","Massachusetts",2,0,0,0,0,2,2,25,0,0,0,0,0,2
"2020-03-04","Massachusetts",2,0,0,0,0,2,2,25,0,0,0,0,0,2
"2020-03-03","Massachusetts",2,0,0,0,0,0,0,0,0,0,0,0,0,0
"2020-03-02","Massachusetts",2,0,0,0,0,0,0,0,0,0,0,0,0,0
"2020-03-01","Massachusetts",2,0,0,0,0,0,0,0,0,0,0,0,0,0
"2020-02-29","Massachusetts",2,0,0,0,0,0,0,0,0,0,0,0,0,0
"2020-02-28","Massachusetts",2,0,0,0,0,0,0,0,0,0,0,0,0,0
"2020-04-09","Michigan",77,31362,0,0,1076,52866,52866,26,117,0,0,1158,1158,21504
"2020-04-08","Michigan",76,31362,0,0,959,51708,51708,26,114,0,0,1376,1376,20346
"2020-04-07","Michigan",74,31362,0,0,845,50332,50332,26,118,0,1332,1749,3081,18970
"2020-04-06","Michigan",73,30030,0,0,727,47251,47251,26,110,0,0,1503,1503,17221
"2020-04-05","Michigan",71,30030,0,0,617,45748,45748,26,77,0,18137,1493,19630,15718
"2020-04-04","Michigan",70,11893,0,0,540,26118,26118,26,61,0,0,1481,1481,14225
"2020-04-03","Michigan",68,11893,0,0,479,24637,24637,26,62,0,0,1953,1953,12744
"2020-04-02","Michigan",66,11893,0,0,417,22684,22684,26,80,0,0,1457,1457,10791
"2020-04-01","Michigan",63,11893,0,0,337,21227,21227,26,78,0,0,1719,1719,9334
"2020-03-31","Michigan",56,11893,0,0,259,19508,19508,26,75,0,0,1117,1117,7615
"2020-03-30","Michigan",51,11893,0,0,184,18391,18391,26,52,0,0,1012,1012,6498
"2020-03-29","Michigan",47,11893,0,0,132,17379,17379,26,40,0,2784,1829,4613,5486
"2020-03-28","Michigan",40,9109,0,0,92,12766,12766,26,0,0,2559,0,2559,3657
"2020-03-27","Michigan",40,6550,0,0,92,10207,10207,26,32,0,0,801,801,3657
"2020-03-26","Michigan",37,6550,0,0,60,9406,9406,26,17,0,4481,562,5043,2856
"2020-03-25","Michigan",35,2069,0,0,43,4363,4363,26,19,0,0,503,503,2294
"2020-03-24","Michigan",33,2069,0,0,24,3860,3860,26,9,0,0,463,463,1791
"2020-03-23","Michigan",31,2069,0,0,15,3397,3397,26,7,0,0,293,293,1328
"2020-03-22","Michigan",30,2069,0,0,8,3104,3104,26,3,0,0,248,248,1035
"2020-03-21","Michigan",25,2069,0,0,5,2856,2856,26,2,0,0,238,238,787
"2020-03-20","Michigan",20,2069,0,0,3,2618,2618,26,0,0,-44,213,169,549
"2020-03-19","Michigan",16,2113,0,0,3,2449,2449,26,3,0,1841,256,2097,336
"2020-03-18","Michigan",10,272,0,0,0,352,352,26,0,0,0,15,15,80
"2020-03-17","Michigan",8,272,0,0,0,337,337,26,0,0,0,12,12,65
"2020-03-16","Michigan",7,272,30,0,0,355,325,26,0,0,67,20,87,53
"2020-03-15","Michigan",5,205,26,0,0,264,238,26,0,0,0,8,8,33
"2020-03-14","Michigan",4,205,26,0,0,256,230,26,0,0,72,9,81,25
"2020-03-13","Michigan",3,133,26,0,0,175,149,26,0,0,42,14,56,16
"2020-03-12","Michigan",2,91,27,0,0,120,93,26,0,0,34,0,34,2
"2020-03-11","Michigan",2,57,18,0,0,77,59,26,0,0,18,2,20,2
"2020-03-10","Michigan",2,39,24,0,0,63,39,26,0,0,3,0,3,0
"2020-03-09","Michigan",2,36,11,0,0,47,36,26,0,0,10,0,10,0
"2020-03-08","Michigan",2,26,10,0,0,36,26,26,0,0,8,0,8,0
"2020-03-07","Michigan",2,18,9,0,0,27,18,26,0,0,10,0,10,0
"2020-03-06","Michigan",2,8,8,0,0,16,8,26,0,0,0,0,0,0
"2020-03-05","Michigan",2,8,0,0,0,8,8,26,0,0,0,0,0,0
"2020-03-04","Michigan",2,0,0,0,0,0,0,0,0,0,0,0,0,0
"2020-03-03","Michigan",2,0,0,0,0,0,0,0,0,0,0,0,0,0
"2020-03-02","Michigan",2,0,0,0,0,0,0,0,0,0,0,0,0,0
"2020-03-01","Michigan",2,0,0,0,0,0,0,0,0,0,0,0,0,0
"2020-02-29","Michigan",2,0,0,0,0,0,0,0,0,0,0,0,0,0
"2020-02-28","Michigan",2,0,0,0,0,0,0,0,0,0,0,0,0,0
"2020-04-09","Minnesota",30,31052,0,293,50,32294,32294,27,11,22,1453,88,1541,1242
"2020-04-08","Minnesota",30,29599,0,271,39,30753,30753,27,5,29,1408,85,1493,1154
"2020-04-07","Minnesota",30,28191,0,242,34,29260,29260,27,4,19,1049,83,1132,1069
"2020-04-06","Minnesota",29,27142,0,223,30,28128,28128,27,1,21,1300,51,1351,986
"2020-04-05","Minnesota",28,25842,0,202,29,26777,26777,27,5,22,1284,70,1354,935
"2020-04-04","Minnesota",27,24558,0,180,24,25423,25423,27,2,24,1120,76,1196,865
"2020-04-03","Minnesota",25,23438,0,156,22,24227,24227,27,4,18,1786,47,1833,789
"2020-04-02","Minnesota",24,21652,0,138,18,22394,22394,27,1,16,1150,53,1203,742
"2020-04-01","Minnesota",23,20502,0,122,17,21191,21191,27,5,10,1351,60,1411,689
"2020-03-31","Minnesota",22,19151,0,112,12,19780,19780,27,2,20,905,53,958,629
"2020-03-30","Minnesota",21,18246,0,92,10,18822,18822,27,1,17,1092,73,1165,576
"2020-03-29","Minnesota",20,17154,0,75,9,17657,17657,27,4,18,1466,62,1528,503
"2020-03-28","Minnesota",18,15688,0,57,5,16129,16129,27,1,6,2083,43,2126,441
"2020-03-27","Minnesota",17,13605,0,51,4,14003,14003,27,2,10,1001,52,1053,398
"2020-03-26","Minnesota",16,12604,0,41,2,12950,12950,27,1,6,1416,59,1475,346
"2020-03-25","Minnesota",15,11188,0,35,1,11475,11475,27,0,14,5638,25,5663,287
"2020-03-24","Minnesota",15,5550,0,21,1,5812,5812,27,0,4,1039,27,1066,262
"2020-03-23","Minnesota",14,4511,0,17,1,4746,4746,27,0,5,0,66,66,235
"2020-03-22","Minnesota",13,4511,0,12,1,4680,4680,27,0,12,559,31,590,169
"2020-03-21","Minnesota",12,3952,0,0,1,4090,4090,27,1,0,211,23,234,138
"2020-03-20","Minnesota",12,3741,0,0,0,3856,3856,27,0,0,792,26,818,115
"2020-03-19","Minnesota",10,2949,0,0,0,3038,3038,27,0,0,264,12,276,89
"2020-03-18","Minnesota",9,2685,0,0,0,2762,2762,27,0,0,409,17,426,77
"2020-03-17","Minnesota",8,2276,0,0,0,2336,2336,27,0,0,437,6,443,60
"2020-03-16","Minnesota",7,1839,0,0,0,1893,1893,27,0,0,452,19,471,54
"2020-03-15","Minnesota",5,1387,0,0,0,1422,1422,27,0,0,540,14,554,35
"2020-03-14","Minnesota",4,847,0,0,0,868,868,27,0,0,306,7,313,21
"2020-03-13","Minnesota",3,541,0,0,0,555,555,27,0,0,234,5,239,14
"2020-03-12","Minnesota",2,307,0,0,0,316,316,27,0,0,90,4,94,9
"2020-03-11","Minnesota",2,217,0,0,0,222,222,27,0,0,85,2,87,5
"2020-03-10","Minnesota",2,132,0,0,0,135,135,27,0,0,52,1,53,3
"2020-03-09","Minnesota",2,80,0,0,0,82,82,27,0,0,32,1,33,2
"2020-03-08","Minnesota",2,48,0,0,0,49,49,27,0,0,0,0,0,1
"2020-03-07","Minnesota",2,48,0,0,0,49,49,27,0,0,12,1,13,1
"2020-03-06","Minnesota",2,36,0,0,0,36,36,27,0,0,0,0,0,0
"2020-03-05","Minnesota",2,0,0,0,0,0,0,0,0,0,0,0,0,0
"2020-03-04","Minnesota",2,0,0,0,0,0,0,0,0,0,0,0,0,0
"2020-03-03","Minnesota",2,0,0,0,0,0,0,0,0,0,0,0,0,0
"2020-03-02","Minnesota",2,0,0,0,0,0,0,0,0,0,0,0,0,0
"2020-03-01","Minnesota",2,0,0,0,0,0,0,0,0,0,0,0,0,0
"2020-02-29","Minnesota",2,0,0,0,0,0,0,0,0,0,0,0,0,0
"2020-02-28","Minnesota",2,0,0,0,0,0,0,0,0,0,0,0,0,0
"2020-04-09","Mississippi",35,18632,0,441,76,20892,20892,28,9,31,0,257,257,2260
"2020-04-08","Mississippi",34,18632,0,410,67,20635,20635,28,8,33,0,88,88,2003
"2020-04-07","Mississippi",33,18632,0,377,59,20547,20547,28,8,-98,0,177,177,1915
"2020-04-06","Mississippi",32,18632,0,475,51,20370,20370,28,8,0,13052,100,13152,1738
"2020-04-05","Mississippi",32,5580,0,475,43,7218,7218,28,8,39,447,183,630,1638
"2020-04-04","Mississippi",31,5133,0,436,35,6588,6588,28,6,16,380,97,477,1455
"2020-04-03","Mississippi",31,4753,0,420,29,6111,6111,28,3,60,0,181,181,1358
"2020-04-02","Mississippi",30,4753,0,360,26,5930,5930,28,4,28,1041,104,1145,1177
"2020-04-01","Mississippi",30,3712,0,332,22,4785,4785,28,2,121,175,136,311,1073
"2020-03-31","Mississippi",28,3537,0,211,20,4474,4474,28,4,16,548,90,638,937
"2020-03-30","Mississippi",26,2989,0,195,16,3836,3836,28,2,-40,429,89,518,847
"2020-03-29","Mississippi",25,2560,0,235,14,3318,3318,28,1,16,0,95,95,758
"2020-03-28","Mississippi",23,2560,0,219,13,3223,3223,28,5,34,0,84,84,663
"2020-03-27","Mississippi",21,2560,0,185,8,3139,3139,28,2,35,269,94,363,579
"2020-03-26","Mississippi",19,2291,0,150,6,2776,2776,28,4,33,725,108,833,485
"2020-03-25","Mississippi",17,1566,0,117,2,1943,1943,28,1,31,14,57,71,377
"2020-03-24","Mississippi",16,1552,0,86,1,1872,1872,28,0,53,409,71,480,320
"2020-03-23","Mississippi",14,1143,0,33,1,1392,1392,28,0,0,29,42,71,249
"2020-03-22","Mississippi",14,1114,0,33,1,1321,1321,28,0,33,419,67,486,207
"2020-03-21","Mississippi",12,695,0,0,1,835,835,28,0,0,0,60,60,140
"2020-03-20","Mississippi",10,695,0,0,1,775,775,28,1,0,143,30,173,80
"2020-03-19","Mississippi",7,552,0,0,0,602,602,28,0,0,73,16,89,50
"2020-03-18","Mississippi",5,479,0,0,0,513,513,28,0,0,111,13,124,34
"2020-03-17","Mississippi",4,368,0,0,0,389,389,28,0,0,91,9,100,21
"2020-03-16","Mississippi",3,277,0,0,0,289,289,28,0,0,193,2,195,12
"2020-03-15","Mississippi",3,84,0,0,0,94,94,28,0,0,0,4,4,10
"2020-03-14","Mississippi",2,84,0,0,0,90,90,28,0,0,43,2,45,6
"2020-03-13","Mississippi",2,41,0,0,0,45,45,28,0,0,0,3,3,4
"2020-03-12","Mississippi",2,41,0,0,0,42,42,28,0,0,21,1,22,1
"2020-03-11","Mississippi",2,20,0,0,0,20,20,28,0,0,20,0,20,0
"2020-03-10","Mississippi",2,0,0,0,0,0,0,28,0,0,0,0,0,0
"2020-03-09","Mississippi",2,0,0,0,0,0,0,28,0,0,0,0,0,0
"2020-03-08","Mississippi",2,0,0,0,0,0,0,28,0,0,0,0,0,0
"2020-03-07","Mississippi",2,0,0,0,0,0,0,28,0,0,0,0,0,0
"2020-03-06","Mississippi",2,0,0,0,0,0,0,0,0,0,0,0,0,0
"2020-03-05","Mississippi",2,0,0,0,0,0,0,0,0,0,0,0,0,0
"2020-03-04","Mississippi",2,0,0,0,0,0,0,0,0,0,0,0,0,0
"2020-03-03","Mississippi",2,0,0,0,0,0,0,0,0,0,0,0,0,0
"2020-03-02","Mississippi",2,0,0,0,0,0,0,0,0,0,0,0,0,0
"2020-03-01","Mississippi",2,0,0,0,0,0,0,0,0,0,0,0,0,0
"2020-02-29","Mississippi",2,0,0,0,0,0,0,0,0,0,0,0,0,0
"2020-02-28","Mississippi",2,0,0,0,0,0,0,0,0,0,0,0,0,0
"2020-04-09","Missouri",40,34955,0,0,77,38494,38494,29,19,0,4172,212,4384,3539
"2020-04-08","Missouri",39,30783,0,0,58,34110,34110,29,5,0,1851,290,2141,3327
"2020-04-07","Missouri",38,28932,0,0,53,31969,31969,29,14,0,1819,315,2134,3037
"2020-04-06","Missouri",36,27113,0,0,39,29835,29835,29,5,0,2231,355,2586,2722
"2020-04-05","Missouri",35,24882,0,0,34,27249,27249,29,10,0,2268,76,2344,2367
"2020-04-04","Missouri",35,22614,0,0,24,24905,24905,29,5,0,3257,178,3435,2291
"2020-04-03","Missouri",34,19357,0,0,19,21470,21470,29,0,0,1508,279,1787,2113
"2020-04-02","Missouri",33,17849,0,0,19,19683,19683,29,1,0,2003,253,2256,1834
"2020-04-01","Missouri",32,15846,0,0,18,17427,17427,29,4,0,1232,254,1486,1581
"2020-03-31","Missouri",31,14614,0,0,14,15941,15941,29,1,0,1410,296,1706,1327
"2020-03-30","Missouri",30,13204,0,0,13,14235,14235,29,3,0,1657,193,1850,1031
"2020-03-29","Missouri",26,11547,0,0,10,12385,12385,29,0,0,1465,0,1465,838
"2020-03-28","Missouri",26,10082,0,0,10,10920,10920,29,2,0,9713,169,9882,838
"2020-03-27","Missouri",23,369,0,0,8,1038,1038,29,0,0,0,167,167,669
"2020-03-26","Missouri",20,369,0,0,8,871,871,29,0,0,0,146,146,502
"2020-03-25","Missouri",17,369,0,0,8,725,725,29,5,0,0,173,173,356
"2020-03-24","Missouri",13,369,0,0,3,552,552,29,0,0,0,0,0,183
"2020-03-23","Missouri",13,369,0,0,3,552,552,29,0,0,0,93,93,183
"2020-03-22","Missouri",11,369,0,0,3,459,459,29,0,0,0,17,17,90
"2020-03-21","Missouri",9,369,0,0,3,442,442,29,2,0,0,26,26,73
"2020-03-20","Missouri",6,369,0,0,1,416,416,29,0,0,61,23,84,47
"2020-03-19","Missouri",4,308,0,0,1,332,332,29,1,0,55,11,66,24
"2020-03-18","Missouri",3,253,0,0,0,266,266,29,0,0,46,5,51,13
"2020-03-17","Missouri",2,207,0,0,0,215,215,29,0,0,43,2,45,8
"2020-03-16","Missouri",2,164,0,0,0,170,170,29,0,0,42,1,43,6
"2020-03-15","Missouri",2,122,0,0,0,127,127,29,0,0,32,1,33,5
"2020-03-14","Missouri",2,90,0,0,0,94,94,29,0,0,19,2,21,4
"2020-03-13","Missouri",2,71,0,0,0,73,73,29,0,0,7,1,8,2
"2020-03-12","Missouri",2,64,0,0,0,65,65,29,0,0,64,0,64,1
"2020-03-11","Missouri",2,0,0,0,0,1,1,29,0,0,0,0,0,1
"2020-03-10","Missouri",2,0,0,0,0,1,1,29,0,0,0,0,0,1
"2020-03-09","Missouri",2,0,0,0,0,1,1,29,0,0,0,0,0,1
"2020-03-08","Missouri",2,0,0,0,0,1,1,29,0,0,0,1,1,1
"2020-03-07","Missouri",2,0,0,0,0,0,0,29,0,0,0,0,0,0
"2020-03-06","Missouri",2,0,0,0,0,0,0,0,0,0,0,0,0,0
"2020-03-05","Missouri",2,0,0,0,0,0,0,0,0,0,0,0,0,0
"2020-03-04","Missouri",2,0,0,0,0,0,0,0,0,0,0,0,0,0
"2020-03-03","Missouri",2,0,0,0,0,0,0,0,0,0,0,0,0,0
"2020-03-02","Missouri",2,0,0,0,0,0,0,0,0,0,0,0,0,0
"2020-03-01","Missouri",2,0,0,0,0,0,0,0,0,0,0,0,0,0
"2020-02-29","Missouri",2,0,0,0,0,0,0,0,0,0,0,0,0,0
"2020-02-28","Missouri",2,0,0,0,0,0,0,0,0,0,0,0,0,0
"2020-04-09","Montana",17,7506,0,36,6,7860,7860,30,0,5,440,22,462,354
"2020-04-08","Montana",16,7066,0,31,6,7398,7398,30,0,3,400,13,413,332
"2020-04-07","Montana",16,6666,0,28,6,6985,6985,30,0,4,175,20,195,319
"2020-04-06","Montana",15,6491,0,24,6,6790,6790,30,0,0,174,13,187,299
"2020-04-05","Montana",15,6317,0,24,6,6603,6603,30,1,0,405,21,426,286
"2020-04-04","Montana",15,5912,0,24,5,6177,6177,30,0,0,579,22,601,265
"2020-04-03","Montana",14,5333,0,24,5,5576,5576,30,0,4,240,16,256,243
"2020-04-02","Montana",14,5093,0,20,5,5320,5320,30,0,3,383,19,402,227
"2020-04-01","Montana",14,4710,0,17,5,4918,4918,30,1,3,476,24,500,208
"2020-03-31","Montana",13,4234,0,14,4,4418,4418,30,0,4,273,13,286,184
"2020-03-30","Montana",13,3961,0,10,4,4132,4132,30,3,2,-182,17,-165,171
"2020-03-29","Montana",13,4143,0,8,1,4297,4297,30,0,1,887,25,912,154
"2020-03-28","Montana",12,3256,0,7,1,3385,3385,30,1,0,666,21,687,129
"2020-03-27","Montana",12,2590,0,7,0,2698,2698,30,0,6,462,37,499,108
"2020-03-26","Montana",9,2128,0,1,0,2199,2199,30,0,1,180,18,198,71
"2020-03-25","Montana",7,1948,0,0,0,2001,2001,30,0,0,305,7,312,53
"2020-03-24","Montana",6,1643,0,0,0,1689,1689,30,0,0,497,12,509,46
"2020-03-23","Montana",5,1146,0,0,0,1180,1180,30,0,0,0,3,3,34
"2020-03-22","Montana",5,1146,0,0,0,1177,1177,30,0,0,0,11,11,31
"2020-03-21","Montana",4,1146,0,0,0,1166,1166,30,0,0,215,4,219,20
"2020-03-20","Montana",3,931,0,0,0,947,947,30,0,0,170,4,174,16
"2020-03-19","Montana",3,761,0,0,0,773,773,30,0,0,262,2,264,12
"2020-03-18","Montana",3,499,0,0,0,509,509,30,0,0,196,2,198,10
"2020-03-17","Montana",2,303,0,0,0,311,311,30,0,0,105,1,106,8
"2020-03-16","Montana",2,198,0,0,0,205,205,30,0,0,95,0,95,7
"2020-03-15","Montana",2,103,57,0,0,167,110,30,0,0,0,2,2,7
"2020-03-14","Montana",2,103,0,0,0,108,108,30,0,0,48,4,52,5
"2020-03-13","Montana",2,55,0,0,0,56,56,30,0,0,21,0,21,1
"2020-03-12","Montana",2,34,0,0,0,35,35,30,0,0,13,1,14,1
"2020-03-11","Montana",2,21,0,0,0,21,21,30,0,0,6,0,6,0
"2020-03-10","Montana",2,15,0,0,0,15,15,30,0,0,4,0,4,0
"2020-03-09","Montana",2,11,0,0,0,11,11,30,0,0,0,0,0,0
"2020-03-08","Montana",2,11,0,0,0,11,11,30,0,0,0,0,0,0
"2020-03-07","Montana",2,11,0,0,0,11,11,30,0,0,0,0,0,0
"2020-03-06","Montana",2,0,0,0,0,0,0,0,0,0,0,0,0,0
"2020-03-05","Montana",2,0,0,0,0,0,0,0,0,0,0,0,0,0
"2020-03-04","Montana",2,0,0,0,0,0,0,0,0,0,0,0,0,0
"2020-03-03","Montana",2,0,0,0,0,0,0,0,0,0,0,0,0,0
"2020-03-02","Montana",2,0,0,0,0,0,0,0,0,0,0,0,0,0
"2020-03-01","Montana",2,0,0,0,0,0,0,0,0,0,0,0,0,0
"2020-02-29","Montana",2,0,0,0,0,0,0,0,0,0,0,0,0,0
"2020-02-28","Montana",2,0,0,0,0,0,0,0,0,0,0,0,0,0
"2020-04-09","Nebraska",21,8116,0,0,14,8683,8683,31,2,0,674,48,722,567
"2020-04-08","Nebraska",20,7442,0,0,12,7961,7961,31,2,0,631,72,703,519
"2020-04-07","Nebraska",18,6811,0,0,10,7258,7258,31,2,0,433,38,471,447
"2020-04-06","Nebraska",18,6378,8,0,8,6795,6787,31,0,0,820,46,866,409
"2020-04-05","Nebraska",17,5558,12,0,8,5933,5921,31,2,0,500,42,542,363
"2020-04-04","Nebraska",16,5058,10,0,6,5389,5379,31,0,0,571,42,613,321
"2020-04-03","Nebraska",15,4487,11,0,6,4777,4766,31,1,0,509,33,542,279
"2020-04-02","Nebraska",14,3978,11,0,5,4235,4224,31,1,0,503,36,539,246
"2020-04-01","Nebraska",14,3475,8,0,4,3693,3685,31,1,0,544,38,582,210
"2020-03-31","Nebraska",13,2931,8,0,3,3111,3103,31,1,0,347,27,374,172
"2020-03-30","Nebraska",12,2584,5,0,2,2734,2729,31,0,0,616,37,653,145
"2020-03-29","Nebraska",12,1968,4,0,2,2080,2076,31,0,0,64,12,76,108
"2020-03-28","Nebraska",11,1904,0,0,2,2000,2000,31,2,0,143,11,154,96
"2020-03-27","Nebraska",10,1761,0,0,0,1846,1846,31,0,0,177,12,189,85
"2020-03-26","Nebraska",9,1584,0,0,0,1657,1657,31,0,0,280,12,292,73
"2020-03-25","Nebraska",8,1304,0,0,0,1365,1365,31,0,0,329,9,338,61
"2020-03-24","Nebraska",7,975,0,0,0,1027,1027,31,0,0,619,2,621,52
"2020-03-23","Nebraska",7,356,0,0,0,406,406,31,0,0,0,2,2,50
"2020-03-22","Nebraska",6,356,0,0,0,404,404,31,0,0,0,10,10,48
"2020-03-21","Nebraska",5,356,0,0,0,394,394,31,0,0,116,6,122,38
"2020-03-20","Nebraska",5,240,0,0,0,272,272,31,0,0,0,5,5,32
"2020-03-19","Nebraska",4,240,0,0,0,267,267,31,0,0,34,3,37,27
"2020-03-18","Nebraska",4,206,0,0,0,230,230,31,0,0,0,3,3,24
"2020-03-17","Nebraska",4,206,0,0,0,227,227,31,0,0,36,3,39,21
"2020-03-16","Nebraska",3,170,0,0,0,188,188,31,0,0,90,1,91,18
"2020-03-15","Nebraska",3,80,33,0,0,130,97,31,0,0,0,3,3,17
"2020-03-14","Nebraska",3,80,33,0,0,127,94,31,0,0,0,1,1,14
"2020-03-13","Nebraska",3,80,33,0,0,126,93,31,0,0,0,3,3,13
"2020-03-12","Nebraska",3,80,33,0,0,123,90,31,0,0,33,5,38,10
"2020-03-11","Nebraska",2,47,16,0,0,68,52,31,0,0,0,2,2,5
"2020-03-10","Nebraska",2,47,16,0,0,66,50,31,0,0,11,0,11,3
"2020-03-09","Nebraska",2,36,9,0,0,48,39,31,0,0,19,2,21,3
"2020-03-08","Nebraska",2,17,5,0,0,23,18,31,0,0,0,0,0,1
"2020-03-07","Nebraska",2,17,5,0,0,23,18,31,0,0,0,1,1,1
"2020-03-06","Nebraska",2,17,5,0,0,22,17,31,0,0,0,0,0,0
"2020-03-05","Nebraska",2,17,5,0,0,22,17,31,0,0,0,0,0,0
"2020-03-04","Nebraska",2,0,0,0,0,0,0,0,0,0,0,0,0,0
"2020-03-03","Nebraska",2,0,0,0,0,0,0,0,0,0,0,0,0,0
"2020-03-02","Nebraska",2,0,0,0,0,0,0,0,0,0,0,0,0,0
"2020-03-01","Nebraska",2,0,0,0,0,0,0,0,0,0,0,0,0,0
"2020-02-29","Nebraska",2,0,0,0,0,0,0,0,0,0,0,0,0,0
"2020-02-28","Nebraska",2,0,0,0,0,0,0,0,0,0,0,0,0,0
"2020-04-09","Nevada",35,19315,0,0,80,21771,21771,32,9,0,1067,138,1205,2456
"2020-04-08","Nevada",35,18248,0,0,71,20566,20566,32,13,0,1696,231,1927,2318
"2020-04-07","Nevada",34,16552,0,0,58,18639,18639,32,12,0,876,134,1010,2087
"2020-04-06","Nevada",33,15676,0,0,46,17629,17629,32,0,0,681,117,798,1953
"2020-04-05","Nevada",33,14995,0,0,46,16831,16831,32,0,0,574,94,668,1836
"2020-04-04","Nevada",32,14421,0,0,46,16163,16163,32,3,0,1403,228,1631,1742
"2020-04-03","Nevada",32,13018,0,0,43,14532,14532,32,5,0,430,56,486,1514
"2020-04-02","Nevada",31,12588,0,0,38,14046,14046,32,12,0,1069,179,1248,1458
"2020-04-01","Nevada",31,11519,0,0,26,12798,12798,32,9,0,838,166,1004,1279
"2020-03-31","Nevada",30,10681,0,0,17,11794,11794,32,2,0,474,105,579,1113
"2020-03-30","Nevada",30,10207,0,0,15,11215,11215,32,1,0,1795,270,2065,1008
"2020-03-29","Nevada",24,8412,0,0,14,9150,9150,32,4,0,511,117,628,738
"2020-03-28","Nevada",22,7901,0,0,10,8522,8522,32,0,0,1740,86,1826,621
"2020-03-27","Nevada",20,6161,0,0,10,6696,6696,32,0,0,1464,115,1579,535
"2020-03-26","Nevada",18,4697,0,0,10,5117,5117,32,4,0,446,99,545,420
"2020-03-25","Nevada",16,4251,0,0,6,4572,4572,32,2,0,297,43,340,321
"2020-03-24","Nevada",15,3954,0,0,4,4232,4232,32,0,0,464,33,497,278
"2020-03-23","Nevada",14,3490,0,0,4,3735,3735,32,2,0,1042,55,1097,245
"2020-03-22","Nevada",13,2448,0,0,2,2638,2638,32,0,0,64,66,130,190
"2020-03-21","Nevada",12,2384,0,0,2,2508,2508,32,1,0,392,15,407,124
"2020-03-20","Nevada",12,1992,0,0,1,2101,2101,32,0,0,366,14,380,109
"2020-03-19","Nevada",11,1626,0,0,1,1721,1721,32,0,0,1458,40,1498,95
"2020-03-18","Nevada",7,168,0,0,1,223,223,32,0,0,0,0,0,55
"2020-03-17","Nevada",7,168,0,0,1,223,223,32,0,0,0,10,10,55
"2020-03-16","Nevada",6,168,0,0,1,213,213,32,1,0,0,24,24,45
"2020-03-15","Nevada",4,168,164,0,0,353,189,32,0,0,0,1,1,21
"2020-03-14","Nevada",4,168,0,0,0,188,188,32,0,0,0,9,9,20
"2020-03-13","Nevada",3,168,0,0,0,179,179,32,0,0,0,4,4,11
"2020-03-12","Nevada",2,168,0,0,0,175,175,32,0,0,0,2,2,7
"2020-03-11","Nevada",2,168,0,0,0,173,173,32,0,0,154,5,159,5
"2020-03-10","Nevada",2,14,0,0,0,14,14,32,0,0,0,0,-1,0
"2020-03-09","Nevada",2,14,0,0,0,15,15,32,0,0,0,0,0,1
"2020-03-08","Nevada",2,14,0,0,0,15,15,32,0,0,0,0,0,1
"2020-03-07","Nevada",2,14,0,0,0,15,15,32,0,0,0,0,0,1
"2020-03-06","Nevada",2,14,0,0,0,15,15,32,0,0,0,0,0,1
"2020-03-05","Nevada",2,14,0,0,0,15,15,32,0,0,0,0,0,1
"2020-03-04","Nevada",2,0,0,0,0,0,0,0,0,0,0,0,0,0
"2020-03-03","Nevada",2,0,0,0,0,0,0,0,0,0,0,0,0,0
"2020-03-02","Nevada",2,0,0,0,0,0,0,0,0,0,0,0,0,0
"2020-03-01","Nevada",2,0,0,0,0,0,0,0,0,0,0,0,0,0
"2020-02-29","Nevada",2,0,0,0,0,0,0,0,0,0,0,0,0,0
"2020-02-28","Nevada",2,0,0,0,0,0,0,0,0,0,0,0,0,0
"2020-04-09","New Hampshire",25,8763,143,118,18,9694,9551,33,0,0,374,0,374,788
"2020-04-08","New Hampshire",25,8389,89,118,18,9266,9177,33,9,15,370,73,443,788
"2020-04-07","New Hampshire",24,8019,49,103,9,8783,8734,33,0,11,318,46,364,715
"2020-04-06","New Hampshire",23,7701,101,92,9,8471,8370,33,0,6,290,48,338,669
"2020-04-05","New Hampshire",22,7411,93,86,9,8125,8032,33,2,6,446,81,527,621
"2020-04-04","New Hampshire",20,6965,94,80,7,7599,7505,33,2,7,390,61,451,540
"2020-04-03","New Hampshire",19,6575,114,73,5,7168,7054,33,1,15,497,64,561,479
"2020-04-02","New Hampshire",18,6078,126,58,4,6619,6493,33,0,2,93,0,93,415
"2020-04-01","New Hampshire",18,5985,97,56,4,6497,6400,33,1,11,572,101,673,415
"2020-03-31","New Hampshire",16,5413,65,45,3,5792,5727,33,0,0,27,0,27,314
"2020-03-30","New Hampshire",16,5386,144,45,3,5844,5700,33,1,12,862,100,962,314
"2020-03-29","New Hampshire",14,4524,285,33,2,5023,4738,33,0,3,868,27,895,214
"2020-03-28","New Hampshire",13,3656,296,30,2,4139,3843,33,1,5,261,29,290,187
"2020-03-27","New Hampshire",13,3395,592,25,1,4145,3553,33,0,6,394,21,415,158
"2020-03-26","New Hampshire",12,3001,712,19,1,3850,3138,33,0,6,645,29,674,137
"2020-03-25","New Hampshire",12,2356,804,13,1,3268,2464,33,0,2,909,7,916,108
"2020-03-24","New Hampshire",12,1447,869,11,1,2417,1548,33,1,11,73,23,96,101
"2020-03-23","New Hampshire",9,1374,889,0,0,2341,1452,33,0,0,186,13,199,78
"2020-03-22","New Hampshire",8,1188,959,0,0,2212,1253,33,0,0,215,10,225,65
"2020-03-21","New Hampshire",7,973,942,0,0,1970,1028,33,0,0,228,11,239,55
"2020-03-20","New Hampshire",6,745,631,0,0,1420,789,33,0,0,124,5,129,44
"2020-03-19","New Hampshire",5,621,231,0,0,891,660,33,0,0,108,13,121,39
"2020-03-18","New Hampshire",4,513,208,0,0,747,539,33,0,0,158,9,167,26
"2020-03-17","New Hampshire",3,355,195,0,0,567,372,33,0,0,84,4,88,17
"2020-03-16","New Hampshire",3,271,95,0,0,379,284,33,0,0,0,0,0,13
"2020-03-15","New Hampshire",3,271,95,0,0,379,284,33,0,0,59,6,65,13
"2020-03-14","New Hampshire",2,212,31,0,0,250,219,33,0,0,118,1,119,7
"2020-03-13","New Hampshire",2,94,21,0,0,121,100,33,0,0,0,0,0,6
"2020-03-12","New Hampshire",2,94,21,0,0,121,100,33,0,0,56,2,58,6
"2020-03-11","New Hampshire",2,38,5,0,0,47,42,33,0,0,0,0,0,4
"2020-03-10","New Hampshire",2,38,5,0,0,47,42,33,0,0,0,0,0,4
"2020-03-09","New Hampshire",2,38,5,0,0,47,42,33,0,0,0,0,0,4
"2020-03-08","New Hampshire",2,38,5,0,0,47,42,33,0,0,18,2,20,4
"2020-03-07","New Hampshire",2,20,3,0,0,25,22,33,0,0,0,0,0,2
"2020-03-06","New Hampshire",2,20,3,0,0,25,22,33,0,0,4,0,4,2
"2020-03-05","New Hampshire",2,16,4,0,0,22,18,33,0,0,6,0,6,2
"2020-03-04","New Hampshire",2,10,7,0,0,19,12,33,0,0,0,0,0,2
"2020-03-03","New Hampshire",2,0,0,0,0,0,0,0,0,0,0,0,0,0
"2020-03-02","New Hampshire",2,0,0,0,0,0,0,0,0,0,0,0,0,0
"2020-03-01","New Hampshire",2,0,0,0,0,0,0,0,0,0,0,0,0,0
"2020-02-29","New Hampshire",2,0,0,0,0,0,0,0,0,0,0,0,0,0
"2020-02-28","New Hampshire",2,0,0,0,0,0,0,0,0,0,0,0,0,0
"2020-04-09","New Jersey",86,56165,0,0,1700,107192,107192,34,196,0,3186,3590,6776,51027
"2020-04-08","New Jersey",85,52979,0,0,1504,100416,100416,34,272,0,2421,3021,5442,47437
"2020-04-07","New Jersey",84,50558,0,0,1232,94974,94974,34,229,0,2616,3326,5942,44416
"2020-04-06","New Jersey",84,47942,0,0,1003,89032,89032,34,86,0,3281,3585,6866,41090
"2020-04-05","New Jersey",83,44661,0,0,917,82166,82166,34,71,0,3429,3381,6810,37505
"2020-04-04","New Jersey",82,41232,0,0,846,75356,75356,34,200,0,3624,4229,7853,34124
"2020-04-03","New Jersey",81,37608,0,0,646,67503,67503,34,109,0,4088,4305,8393,29895
"2020-04-02","New Jersey",81,33520,0,0,537,59110,59110,34,182,0,3133,3335,6468,25590
"2020-04-01","New Jersey",78,30387,0,0,355,52642,52642,34,88,0,3310,3559,6869,22255
"2020-03-31","New Jersey",74,27077,0,0,267,45773,45773,34,69,0,1853,2060,3913,18696
"2020-03-30","New Jersey",72,25224,0,0,198,41860,41860,34,37,0,3008,3250,6258,16636
"2020-03-29","New Jersey",69,22216,0,0,161,35602,35602,34,21,0,2830,2262,5092,13386
"2020-03-28","New Jersey",67,19386,0,0,140,30510,30510,34,32,0,2839,2299,5138,11124
"2020-03-27","New Jersey",61,16547,0,0,108,25372,25372,34,27,0,2886,1949,4835,8825
"2020-03-26","New Jersey",53,13661,0,0,81,20537,20537,34,19,0,3209,2474,5683,6876
"2020-03-25","New Jersey",43,10452,0,0,62,14854,14854,34,18,0,2127,727,2854,4402
"2020-03-24","New Jersey",40,8325,45,0,44,12045,12000,34,17,0,7966,831,8797,3675
"2020-03-23","New Jersey",37,359,94,0,27,3297,3203,34,7,0,32,930,962,2844
"2020-03-22","New Jersey",33,327,49,0,20,2290,2241,34,4,0,33,587,620,1914
"2020-03-21","New Jersey",31,294,40,0,16,1661,1621,34,5,0,30,437,467,1327
"2020-03-20","New Jersey",27,264,86,0,11,1240,1154,34,2,0,54,148,202,890
"2020-03-19","New Jersey",24,210,74,0,9,1026,952,34,4,0,20,315,335,742
"2020-03-18","New Jersey",18,190,21,0,5,638,617,34,2,0,27,160,187,427
"2020-03-17","New Jersey",15,163,55,0,3,485,430,34,1,0,43,89,132,267
"2020-03-16","New Jersey",13,120,20,0,2,318,298,34,0,0,0,80,80,178
"2020-03-15","New Jersey",11,120,34,0,2,252,218,34,1,0,23,48,71,98
"2020-03-14","New Jersey",7,97,80,0,1,227,147,34,0,0,0,0,0,50
"2020-03-13","New Jersey",7,97,80,0,1,227,147,34,0,0,23,20,43,50
"2020-03-12","New Jersey",5,74,20,0,1,124,104,34,0,0,17,6,23,30
"2020-03-11","New Jersey",4,57,20,0,1,101,81,34,1,0,13,9,22,24
"2020-03-10","New Jersey",3,44,20,0,0,79,59,34,0,0,9,4,13,15
"2020-03-09","New Jersey",3,35,14,0,0,60,46,34,0,0,4,5,9,11
"2020-03-08","New Jersey",2,31,0,0,0,37,37,34,0,0,31,2,33,6
"2020-03-07","New Jersey",2,0,1,0,0,5,4,34,0,0,0,3,3,4
"2020-03-06","New Jersey",2,0,0,0,0,1,1,34,0,0,0,0,0,1
"2020-03-05","New Jersey",2,0,0,0,0,1,1,34,0,0,0,0,0,1
"2020-03-04","New Jersey",2,0,0,0,0,0,0,0,0,0,0,0,0,0
"2020-03-03","New Jersey",2,0,0,0,0,0,0,0,0,0,0,0,0,0
"2020-03-02","New Jersey",2,0,0,0,0,0,0,0,0,0,0,0,0,0
"2020-03-01","New Jersey",2,0,0,0,0,0,0,0,0,0,0,0,0,0
"2020-02-29","New Jersey",2,0,0,0,0,0,0,0,0,0,0,0,0,0
"2020-02-28","New Jersey",2,0,0,0,0,0,0,0,0,0,0,0,0,0
"2020-04-09","New Mexico",27,22942,0,0,16,23807,23807,35,3,0,1491,71,1562,865
"2020-04-08","New Mexico",25,21451,0,0,13,22245,22245,35,1,0,312,108,420,794
"2020-04-07","New Mexico",23,21139,0,0,12,21825,21825,35,0,0,2627,62,2689,686
"2020-04-06","New Mexico",22,18512,0,0,12,19136,19136,35,1,0,2227,81,2308,624
"2020-04-05","New Mexico",20,16285,0,0,11,16828,16828,35,1,0,1148,48,1196,543
"2020-04-04","New Mexico",19,15137,0,0,10,15632,15632,35,3,0,762,92,854,495
"2020-04-03","New Mexico",18,14375,0,0,7,14778,14778,35,1,0,727,40,767,403
"2020-04-02","New Mexico",17,13648,0,0,6,14011,14011,35,1,0,723,48,771,363
"2020-04-01","New Mexico",16,12925,0,0,5,13240,13240,35,1,0,679,34,713,315
"2020-03-31","New Mexico",15,12246,0,0,4,12527,12527,35,2,0,1304,44,1348,281
"2020-03-30","New Mexico",14,10942,0,0,2,11179,11179,35,0,0,173,0,173,237
"2020-03-29","New Mexico",14,10769,0,0,2,11006,11006,35,1,0,1573,46,1619,237
"2020-03-28","New Mexico",13,9196,0,0,1,9387,9387,35,0,0,819,55,874,191
"2020-03-27","New Mexico",12,8377,0,0,1,8513,8513,35,0,0,696,24,720,136
"2020-03-26","New Mexico",12,7681,0,0,1,7793,7793,35,0,0,939,12,951,112
"2020-03-25","New Mexico",12,6742,0,0,1,6842,6842,35,1,0,852,17,869,100
"2020-03-24","New Mexico",10,5890,0,0,0,5973,5973,35,0,0,569,18,587,83
"2020-03-23","New Mexico",8,5321,0,0,0,5386,5386,35,0,0,599,8,607,65
"2020-03-22","New Mexico",7,4722,0,0,0,4779,4779,35,0,0,951,0,951,57
"2020-03-21","New Mexico",7,3771,0,0,0,3828,3828,35,0,0,0,14,14,57
"2020-03-20","New Mexico",6,3771,0,0,0,3814,3814,35,0,0,1009,8,1017,43
"2020-03-19","New Mexico",5,2762,0,0,0,2797,2797,35,0,0,436,7,443,35
"2020-03-18","New Mexico",4,2326,0,0,0,2354,2354,35,0,0,1077,5,1082,28
"2020-03-17","New Mexico",4,1249,0,0,0,1272,1272,35,0,0,683,6,689,23
"2020-03-16","New Mexico",3,566,0,0,0,583,583,35,0,0,84,4,88,17
"2020-03-15","New Mexico",3,482,0,0,0,495,495,35,0,0,245,3,248,13
"2020-03-14","New Mexico",3,237,0,0,0,247,247,35,0,0,47,0,47,10
"2020-03-13","New Mexico",3,190,0,0,0,200,200,35,0,0,35,5,40,10
"2020-03-12","New Mexico",2,155,0,0,0,160,160,35,0,0,68,2,70,5
"2020-03-11","New Mexico",2,87,0,0,0,90,90,35,0,0,18,3,21,3
"2020-03-10","New Mexico",2,69,0,0,0,69,69,35,0,0,12,0,12,0
"2020-03-09","New Mexico",2,57,0,0,0,57,57,35,0,0,9,0,9,0
"2020-03-08","New Mexico",2,48,0,0,0,48,48,35,0,0,0,0,0,0
"2020-03-07","New Mexico",2,48,0,0,0,48,48,35,0,0,32,0,32,0
"2020-03-06","New Mexico",2,16,0,0,0,16,16,35,0,0,0,0,0,0
"2020-03-05","New Mexico",2,0,0,0,0,0,0,0,0,0,0,0,0,0
"2020-03-04","New Mexico",2,0,0,0,0,0,0,0,0,0,0,0,0,0
"2020-03-03","New Mexico",2,0,0,0,0,0,0,0,0,0,0,0,0,0
"2020-03-02","New Mexico",2,0,0,0,0,0,0,0,0,0,0,0,0,0
"2020-03-01","New Mexico",2,0,0,0,0,0,0,0,0,0,0,0,0,0
"2020-02-29","New Mexico",2,0,0,0,0,0,0,0,0,0,0,0,0,0
"2020-02-28","New Mexico",2,0,0,0,0,0,0,0,0,0,0,0,0,0
"2020-04-09","New York",93,231612,0,32869,7067,391549,391549,36,799,200,15775,10621,26396,159937
"2020-04-08","New York",92,215837,0,32669,6268,365153,365153,36,779,586,14642,10453,25095,149316
"2020-04-07","New York",92,201195,0,32083,5489,340058,340058,36,731,1880,11073,8174,19247,138863
"2020-04-06","New York",92,190122,0,30203,4758,320811,320811,36,599,2111,9873,8658,18531,130689
"2020-04-05","New York",91,180249,0,28092,4159,302280,302280,36,594,1709,10332,8327,18659,122031
"2020-04-04","New York",91,169917,0,26383,3565,283621,283621,36,630,2687,12260,10841,23101,113704
"2020-04-03","New York",91,157657,0,23696,2935,260520,260520,36,562,2879,11073,10482,21555,102863
"2020-04-02","New York",90,146584,0,20817,2373,238965,238965,36,432,2449,9416,8669,18085,92381
"2020-04-01","New York",89,137168,0,18368,1941,220880,220880,36,391,2464,7777,7917,15694,83712
"2020-03-31","New York",88,129391,0,15904,1550,205186,205186,36,332,2183,9420,9298,18718,75795
"2020-03-30","New York",87,119971,0,13721,1218,186468,186468,36,253,1646,7124,6984,14108,66497
"2020-03-29","New York",86,112847,0,12075,965,172360,172360,36,237,2021,9231,7195,16426,59513
"2020-03-28","New York",86,103616,0,10054,728,155934,155934,36,209,1528,2498,7683,10181,52318
"2020-03-27","New York",84,101118,0,8526,519,145753,145753,36,134,1682,16272,7377,23649,44635
"2020-03-26","New York",83,84846,0,6844,385,122104,122104,36,100,3039,12178,6447,18625,37258
"2020-03-25","New York",82,72668,0,3805,285,103479,103479,36,75,571,7063,5146,12209,30811
"2020-03-24","New York",81,65605,0,3234,210,91270,91270,36,96,599,8191,4790,12981,25665
"2020-03-23","New York",76,57414,0,2635,114,78289,78289,36,0,661,11181,5707,16888,20875
"2020-03-22","New York",71,46233,0,1974,114,61401,61401,36,70,371,11152,4812,15964,15168
"2020-03-21","New York",66,35081,0,1603,44,45437,45437,36,9,1603,9756,3254,13010,10356
"2020-03-20","New York",54,25325,0,0,35,32427,32427,36,23,0,7193,2950,10143,7102
"2020-03-19","New York",42,18132,0,0,12,22284,22284,36,0,0,5917,1770,7687,4152
"2020-03-18","New York",35,12215,0,0,12,14597,14597,36,5,0,6709,682,7391,2382
"2020-03-17","New York",32,5506,0,0,7,7206,7206,36,0,0,963,750,1713,1700
"2020-03-16","New York",29,4543,0,0,7,5493,5493,36,4,0,0,221,221,950
"2020-03-15","New York",24,4543,0,0,3,5272,5272,36,3,0,1764,205,1969,729
"2020-03-14","New York",20,2779,0,0,0,3303,3303,36,0,0,0,103,103,524
"2020-03-13","New York",18,2779,0,0,0,3200,3200,36,0,0,2687,205,2892,421
"2020-03-12","New York",14,92,0,0,0,308,308,36,0,0,0,0,0,216
"2020-03-11","New York",14,92,0,0,0,308,308,36,0,0,0,43,43,216
"2020-03-10","New York",13,92,0,0,0,265,265,36,0,0,0,31,31,173
"2020-03-09","New York",12,92,0,0,0,234,234,36,0,0,0,37,37,142
"2020-03-08","New York",12,92,0,0,0,197,197,36,0,0,0,29,29,105
"2020-03-07","New York",9,92,236,0,0,404,168,36,0,0,0,43,43,76
"2020-03-06","New York",5,92,236,0,0,361,125,36,0,0,16,11,27,33
"2020-03-05","New York",4,76,24,0,0,122,98,36,0,0,28,16,44,22
"2020-03-04","New York",2,48,24,0,0,78,54,36,0,0,0,0,0,6
"2020-03-03","New York",2,0,0,0,0,0,0,0,0,0,0,0,0,0
"2020-03-02","New York",2,0,0,0,0,0,0,0,0,0,0,0,0,0
"2020-03-01","New York",2,0,0,0,0,0,0,0,0,0,0,0,0,0
"2020-02-29","New York",2,0,0,0,0,0,0,0,0,0,0,0,0,0
"2020-02-28","New York",2,0,0,0,0,0,0,0,0,0,0,0,0,0
"2020-04-09","North Carolina",40,44158,0,0,65,47809,47809,37,12,0,4597,225,4822,3651
"2020-04-08","North Carolina",39,39561,0,0,53,42987,42987,37,7,0,1700,205,1905,3426
"2020-04-07","North Carolina",38,37861,0,0,46,41082,41082,37,13,0,5,351,356,3221
"2020-04-06","North Carolina",37,37856,0,0,33,40726,40726,37,2,0,396,285,681,2870
"2020-04-05","North Carolina",36,37460,0,0,31,40045,40045,37,7,0,1089,183,1272,2585
"2020-04-04","North Carolina",35,36371,0,0,24,38773,38773,37,5,0,6866,309,7175,2402
"2020-04-03","North Carolina",34,29505,0,0,19,31598,31598,37,3,0,2683,236,2919,2093
"2020-04-02","North Carolina",33,26822,0,0,16,28679,28679,37,6,0,2163,273,2436,1857
"2020-04-01","North Carolina",32,24659,0,0,10,26243,26243,37,2,0,3051,86,3137,1584
"2020-03-31","North Carolina",31,21608,0,0,8,23106,23106,37,2,0,2051,191,2242,1498
"2020-03-30","North Carolina",31,19557,0,0,6,20864,20864,37,2,0,1652,267,1919,1307
"2020-03-29","North Carolina",30,17905,0,0,4,18945,18945,37,0,0,1313,105,1418,1040
"2020-03-28","North Carolina",28,16592,0,0,4,17527,17527,37,1,0,2219,172,2391,935
"2020-03-27","North Carolina",25,14373,0,0,3,15136,15136,37,1,0,2099,127,2226,763
"2020-03-26","North Carolina",22,12274,0,0,2,12910,12910,37,1,0,2289,132,2421,636
"2020-03-25","North Carolina",20,9985,0,0,1,10489,10489,37,1,0,1844,106,1950,504
"2020-03-24","North Carolina",17,8141,0,0,0,8539,8539,37,0,0,0,101,101,398
"2020-03-23","North Carolina",15,8141,0,0,0,8438,8438,37,0,0,1958,42,2000,297
"2020-03-22","North Carolina",15,6183,0,0,0,6438,6438,37,0,0,1091,71,1162,255
"2020-03-21","North Carolina",13,5092,0,0,0,5276,5276,37,0,0,1996,47,2043,184
"2020-03-20","North Carolina",12,3096,0,0,0,3233,3233,37,0,0,688,40,728,137
"2020-03-19","North Carolina",11,2408,0,0,0,2505,2505,37,0,0,621,34,655,97
"2020-03-18","North Carolina",8,1787,0,0,0,1850,1850,37,0,0,1313,23,1336,63
"2020-03-17","North Carolina",6,474,0,0,0,514,514,37,0,0,178,7,185,40
"2020-03-16","North Carolina",5,296,151,0,0,480,329,37,0,0,69,1,70,33
"2020-03-15","North Carolina",5,227,151,0,0,410,259,37,0,0,90,9,99,32
"2020-03-14","North Carolina",4,137,0,0,0,160,160,37,0,0,51,8,59,23
"2020-03-13","North Carolina",3,86,0,0,0,101,101,37,0,0,26,3,29,15
"2020-03-12","North Carolina",3,60,0,0,0,72,72,37,0,0,60,5,65,12
"2020-03-11","North Carolina",2,0,0,0,0,7,7,37,0,0,0,0,0,7
"2020-03-10","North Carolina",2,0,0,0,0,7,7,37,0,0,0,5,5,7
"2020-03-09","North Carolina",2,0,0,0,0,2,2,37,0,0,0,0,0,2
"2020-03-08","North Carolina",2,0,0,0,0,2,2,37,0,0,0,0,0,2
"2020-03-07","North Carolina",2,0,0,0,0,2,2,37,0,0,0,0,0,2
"2020-03-06","North Carolina",2,0,0,0,0,2,2,37,0,0,0,1,1,2
"2020-03-05","North Carolina",2,0,0,0,0,1,1,37,0,0,0,0,0,1
"2020-03-04","North Carolina",2,0,0,0,0,1,1,37,0,0,0,0,0,1
"2020-03-03","North Carolina",2,0,0,0,0,0,0,0,0,0,0,0,0,0
"2020-03-02","North Carolina",2,0,0,0,0,0,0,0,0,0,0,0,0,0
"2020-03-01","North Carolina",2,0,0,0,0,0,0,0,0,0,0,0,0,0
"2020-02-29","North Carolina",2,0,0,0,0,0,0,0,0,0,0,0,0,0
"2020-02-28","North Carolina",2,0,0,0,0,0,0,0,0,0,0,0,0,0
"2020-04-09","North Dakota",15,8721,0,34,5,8990,8990,38,1,0,420,18,438,269
"2020-04-08","North Dakota",15,8301,0,34,4,8552,8552,38,0,1,835,14,849,251
"2020-04-07","North Dakota",14,7466,0,33,4,7703,7703,38,1,1,478,12,490,237
"2020-04-06","North Dakota",14,6988,0,32,3,7213,7213,38,0,1,408,18,426,225
"2020-04-05","North Dakota",14,6580,0,31,3,6787,6787,38,0,1,559,21,580,207
"2020-04-04","North Dakota",13,6021,0,30,3,6207,6207,38,0,1,396,13,409,186
"2020-04-03","North Dakota",13,5625,0,29,3,5798,5798,38,0,1,804,14,818,173
"2020-04-02","North Dakota",13,4821,0,28,3,4980,4980,38,0,5,470,17,487,159
"2020-04-01","North Dakota",12,4351,0,23,3,4493,4493,38,0,2,220,16,236,142
"2020-03-31","North Dakota",12,4131,0,21,3,4257,4257,38,1,2,403,17,420,126
"2020-03-30","North Dakota",12,3728,0,19,2,3837,3837,38,1,2,373,11,384,109
"2020-03-29","North Dakota",11,3355,0,17,1,3453,3453,38,0,1,546,15,561,98
"2020-03-28","North Dakota",10,2809,0,16,1,2892,2892,38,1,3,382,18,400,83
"2020-03-27","North Dakota",8,2427,0,13,0,2492,2492,38,0,3,388,13,401,65
"2020-03-26","North Dakota",7,2039,0,10,0,2091,2091,38,0,2,305,13,318,52
"2020-03-25","North Dakota",5,1734,0,8,0,1773,1773,38,0,3,280,5,285,39
"2020-03-24","North Dakota",5,1454,0,5,0,1488,1488,38,0,1,101,4,105,34
"2020-03-23","North Dakota",5,1353,0,4,0,1383,1383,38,0,1,93,2,95,30
"2020-03-22","North Dakota",4,1260,0,3,0,1288,1288,38,0,0,119,0,119,28
"2020-03-21","North Dakota",4,1141,0,3,0,1169,1169,38,0,3,341,8,349,28
"2020-03-20","North Dakota",4,800,0,0,0,820,820,38,0,0,307,5,312,20
"2020-03-19","North Dakota",3,493,0,0,0,508,508,38,0,0,225,9,234,15
"2020-03-18","North Dakota",2,268,0,0,0,274,274,38,0,0,48,3,51,6
"2020-03-17","North Dakota",2,220,0,0,0,223,223,38,0,0,97,2,99,3
"2020-03-16","North Dakota",2,123,0,0,0,124,124,38,0,0,28,0,28,1
"2020-03-15","North Dakota",2,95,4,0,0,100,96,38,0,0,41,0,41,1
"2020-03-14","North Dakota",2,54,14,0,0,69,55,38,0,0,15,0,15,1
"2020-03-13","North Dakota",2,39,12,0,0,52,40,38,0,0,27,0,27,1
"2020-03-12","North Dakota",2,12,14,0,0,27,13,38,0,0,5,1,6,1
"2020-03-11","North Dakota",2,7,6,0,0,13,7,38,0,0,1,0,1,0
"2020-03-10","North Dakota",2,6,2,0,0,8,6,38,0,0,6,0,6,0
"2020-03-09","North Dakota",2,0,0,0,0,0,0,38,0,0,0,0,0,0
"2020-03-08","North Dakota",2,0,0,0,0,0,0,38,0,0,0,0,0,0
"2020-03-07","North Dakota",2,0,0,0,0,0,0,38,0,0,0,0,0,0
"2020-03-06","North Dakota",2,0,0,0,0,0,0,0,0,0,0,0,0,0
"2020-03-05","North Dakota",2,0,0,0,0,0,0,0,0,0,0,0,0,0
"2020-03-04","North Dakota",2,0,0,0,0,0,0,0,0,0,0,0,0,0
"2020-03-03","North Dakota",2,0,0,0,0,0,0,0,0,0,0,0,0,0
"2020-03-02","North Dakota",2,0,0,0,0,0,0,0,0,0,0,0,0,0
"2020-03-01","North Dakota",2,0,0,0,0,0,0,0,0,0,0,0,0,0
"2020-02-29","North Dakota",2,0,0,0,0,0,0,0,0,0,0,0,0,0
"2020-02-28","North Dakota",2,0,0,0,0,0,0,0,0,0,0,0,0,0
"2020-04-09","Ohio",48,50473,0,1612,213,55985,55985,39,20,117,2280,364,2644,5512
"2020-04-08","Ohio",46,48193,0,1495,193,53341,53341,39,26,141,2137,366,2503,5148
"2020-04-07","Ohio",45,46056,0,1354,167,50838,50838,39,25,140,2128,332,2460,4782
"2020-04-06","Ohio",43,43928,0,1214,142,48378,48378,39,23,110,4215,407,4622,4450
"2020-04-05","Ohio",42,39713,0,1104,119,43756,43756,39,17,98,1581,304,1885,4043
"2020-04-04","Ohio",40,38132,0,1006,102,41871,41871,39,11,111,3069,427,3496,3739
"2020-04-03","Ohio",39,35063,0,895,91,38375,38375,39,10,93,3047,410,3457,3312
"2020-04-02","Ohio",37,32016,0,802,81,34918,34918,39,16,123,5024,355,5379,2902
"2020-04-01","Ohio",36,26992,0,679,65,29539,29539,39,10,94,0,348,348,2547
"2020-03-31","Ohio",34,26992,0,585,55,29191,29191,39,16,110,1650,266,1916,2199
"2020-03-30","Ohio",33,25342,0,475,39,27275,27275,39,10,72,6330,280,6610,1933
"2020-03-29","Ohio",32,19012,0,403,29,20665,20665,39,4,59,0,247,247,1653
"2020-03-28","Ohio",31,19012,0,344,25,20418,20418,39,6,68,0,269,269,1406
"2020-03-27","Ohio",30,19012,0,276,19,20149,20149,39,4,53,2563,270,2833,1137
"2020-03-26","Ohio",27,16449,0,223,15,17316,17316,39,5,41,2389,163,2552,867
"2020-03-25","Ohio",24,14060,0,182,10,14764,14764,39,2,37,13920,140,14060,704
"2020-03-24","Ohio",21,140,0,145,8,704,704,39,2,41,0,122,122,564
"2020-03-23","Ohio",18,140,0,104,6,582,582,39,3,21,0,91,91,442
"2020-03-22","Ohio",17,140,0,83,3,491,491,39,0,25,0,104,104,351
"2020-03-21","Ohio",14,140,0,58,3,387,387,39,2,58,0,78,78,247
"2020-03-20","Ohio",13,140,0,0,1,309,309,39,1,0,0,50,50,169
"2020-03-19","Ohio",12,140,0,0,0,259,259,39,0,0,0,31,31,119
"2020-03-18","Ohio",10,140,0,0,0,228,228,39,0,0,0,21,21,88
"2020-03-17","Ohio",8,140,0,0,0,207,207,39,0,0,0,17,17,67
"2020-03-16","Ohio",7,140,361,0,0,551,190,39,0,0,1,14,15,50
"2020-03-15","Ohio",5,139,350,0,0,525,175,39,0,0,89,23,112,36
"2020-03-14","Ohio",3,50,159,0,0,222,63,39,0,0,0,0,0,13
"2020-03-13","Ohio",3,50,159,0,0,222,63,39,0,0,20,8,28,13
"2020-03-12","Ohio",2,30,52,0,0,87,35,39,0,0,9,1,10,5
"2020-03-11","Ohio",2,21,24,0,0,49,25,39,0,0,7,1,8,4
"2020-03-10","Ohio",2,14,15,0,0,32,17,39,0,0,3,0,3,3
"2020-03-09","Ohio",2,11,5,0,0,19,14,39,0,0,1,3,4,3
"2020-03-08","Ohio",2,10,4,0,0,14,10,39,0,0,1,0,1,0
"2020-03-07","Ohio",2,9,5,0,0,14,9,39,0,0,1,0,1,0
"2020-03-06","Ohio",2,8,2,0,0,10,8,39,0,0,1,0,1,0
"2020-03-05","Ohio",2,7,3,0,0,10,7,39,0,0,0,0,0,0
"2020-03-04","Ohio",2,0,0,0,0,0,0,0,0,0,0,0,0,0
"2020-03-03","Ohio",2,0,0,0,0,0,0,0,0,0,0,0,0,0
"2020-03-02","Ohio",2,0,0,0,0,0,0,0,0,0,0,0,0,0
"2020-03-01","Ohio",2,0,0,0,0,0,0,0,0,0,0,0,0,0
"2020-02-29","Ohio",2,0,0,0,0,0,0,0,0,0,0,0,0,0
"2020-02-28","Ohio",2,0,0,0,0,0,0,0,0,0,0,0,0,0
"2020-04-09","Oklahoma",32,18595,0,415,80,20279,20279,40,1,25,6774,160,6934,1684
"2020-04-08","Oklahoma",32,11821,0,390,79,13345,13345,40,12,14,0,52,52,1524
"2020-04-07","Oklahoma",31,11821,0,376,67,13293,13293,40,16,36,10399,145,10544,1472
"2020-04-06","Oklahoma",31,1422,0,340,51,2749,2749,40,5,10,21,75,96,1327
"2020-04-05","Oklahoma",31,1401,0,330,46,2653,2653,40,4,14,39,93,132,1252
"2020-04-04","Oklahoma",30,1362,0,316,42,2521,2521,40,4,27,47,171,218,1159
"2020-04-03","Oklahoma",29,1315,0,289,38,2303,2303,40,4,32,50,109,159,988
"2020-04-02","Oklahoma",27,1265,0,257,34,2144,2144,40,4,38,17,160,177,879
"2020-04-01","Oklahoma",24,1248,0,219,30,1967,1967,40,7,42,19,154,173,719
"2020-03-31","Oklahoma",21,1229,0,177,23,1794,1794,40,6,24,22,84,106,565
"2020-03-30","Oklahoma",19,1207,0,153,17,1688,1688,40,1,13,2,52,54,481
"2020-03-29","Oklahoma",18,1205,0,140,16,1634,1634,40,1,14,25,52,77,429
"2020-03-28","Oklahoma",17,1180,0,126,15,1557,1557,40,7,21,96,55,151,377
"2020-03-27","Oklahoma",16,1084,0,105,8,1406,1406,40,1,19,126,74,200,322
"2020-03-26","Oklahoma",14,958,0,86,7,1206,1206,40,2,27,153,84,237,248
"2020-03-25","Oklahoma",13,805,0,59,5,969,969,40,2,34,70,58,128,164
"2020-03-24","Oklahoma",12,735,0,25,3,841,841,40,1,10,41,25,66,106
"2020-03-23","Oklahoma",10,694,102,15,2,877,775,40,0,4,25,14,39,81
"2020-03-22","Oklahoma",8,669,102,11,2,838,736,40,1,1,109,14,123,67
"2020-03-21","Oklahoma",7,560,144,10,1,757,613,40,0,10,22,4,26,53
"2020-03-20","Oklahoma",6,538,374,0,1,961,587,40,0,0,72,5,77,49
"2020-03-19","Oklahoma",6,466,250,0,1,760,510,40,1,0,88,15,103,44
"2020-03-18","Oklahoma",4,378,110,0,0,517,407,40,0,0,131,12,143,29
"2020-03-17","Oklahoma",3,247,82,0,0,346,264,40,0,0,73,7,80,17
"2020-03-16","Oklahoma",3,174,29,0,0,213,184,40,0,0,56,1,57,10
"2020-03-15","Oklahoma",2,118,12,0,0,139,127,40,0,0,82,5,87,9
"2020-03-14","Oklahoma",2,36,37,0,0,77,40,40,0,0,0,1,1,4
"2020-03-13","Oklahoma",2,36,37,0,0,76,39,40,0,0,0,0,0,3
"2020-03-12","Oklahoma",2,36,4,0,0,43,39,40,0,0,21,1,22,3
"2020-03-11","Oklahoma",2,15,11,0,0,28,17,40,0,0,0,0,0,2
"2020-03-10","Oklahoma",2,15,11,0,0,28,17,40,0,0,7,1,8,2
"2020-03-09","Oklahoma",2,8,10,0,0,19,9,40,0,0,0,0,0,1
"2020-03-08","Oklahoma",2,8,2,0,0,11,9,40,0,0,8,0,8,1
"2020-03-07","Oklahoma",2,0,0,0,0,1,1,40,0,0,0,0,0,1
"2020-03-06","Oklahoma",2,0,0,0,0,0,0,0,0,0,0,0,0,0
"2020-03-05","Oklahoma",2,0,0,0,0,0,0,0,0,0,0,0,0,0
"2020-03-04","Oklahoma",2,0,0,0,0,0,0,0,0,0,0,0,0,0
"2020-03-03","Oklahoma",2,0,0,0,0,0,0,0,0,0,0,0,0,0
"2020-03-02","Oklahoma",2,0,0,0,0,0,0,0,0,0,0,0,0,0
"2020-03-01","Oklahoma",2,0,0,0,0,0,0,0,0,0,0,0,0,0
"2020-02-29","Oklahoma",2,0,0,0,0,0,0,0,0,0,0,0,0,0
"2020-02-28","Oklahoma",2,0,0,0,0,0,0,0,0,0,0,0,0,0
"2020-04-09","Oregon",31,24306,0,326,44,25627,25627,41,11,2,981,82,1063,1321
"2020-04-08","Oregon",30,23325,0,324,33,24564,24564,41,0,0,1499,58,1557,1239
"2020-04-07","Oregon",30,21826,0,324,33,23007,23007,41,6,66,1157,49,1206,1181
"2020-04-06","Oregon",30,20669,0,258,27,21801,21801,41,0,0,1113,64,1177,1132
"2020-04-05","Oregon",30,19556,0,258,27,20624,20624,41,1,19,3021,69,3090,1068
"2020-04-04","Oregon",29,16535,0,239,26,17534,17534,41,4,35,0,100,100,999
"2020-04-03","Oregon",27,16535,0,204,22,17434,17434,41,1,16,1276,73,1349,899
"2020-04-02","Oregon",26,15259,0,188,21,16085,16085,41,3,34,2123,90,2213,826
"2020-04-01","Oregon",24,13136,0,154,18,13872,13872,41,0,0,0,46,46,736
"2020-03-31","Oregon",23,13136,0,154,18,13826,13826,41,2,14,859,84,943,690
"2020-03-30","Oregon",22,12277,0,140,16,12883,12883,41,3,11,1399,58,1457,606
"2020-03-29","Oregon",20,10878,0,129,13,11426,11426,41,0,12,1185,69,1254,548
"2020-03-28","Oregon",19,9693,0,117,13,10172,10172,41,1,15,1183,65,1248,479
"2020-03-27","Oregon",18,8510,0,102,12,8924,8924,41,1,12,1557,87,1644,414
"2020-03-26","Oregon",16,6953,0,90,11,7280,7280,41,3,29,2603,118,2721,327
"2020-03-25","Oregon",14,4350,0,61,8,4559,4559,41,0,0,0,0,0,209
"2020-03-24","Oregon",14,4350,0,61,8,4559,4559,41,3,5,701,18,719,209
"2020-03-23","Oregon",13,3649,0,56,5,3840,3840,41,1,13,785,30,815,191
"2020-03-22","Oregon",13,2864,0,43,4,3025,3025,41,1,43,861,47,908,161
"2020-03-21","Oregon",12,2003,433,0,3,2550,2117,41,0,0,0,0,0,114
"2020-03-20","Oregon",12,2003,433,0,3,2550,2117,41,0,0,674,26,700,114
"2020-03-19","Oregon",10,1329,437,0,3,1854,1417,41,0,0,211,13,224,88
"2020-03-18","Oregon",9,1118,361,0,3,1554,1193,41,3,0,429,28,457,75
"2020-03-17","Oregon",6,689,184,0,0,920,736,41,0,0,110,8,118,47
"2020-03-16","Oregon",5,579,182,0,0,800,618,41,0,0,159,3,162,39
"2020-03-15","Oregon",5,420,225,0,0,681,456,41,0,0,83,6,89,36
"2020-03-14","Oregon",5,337,157,0,0,524,367,41,0,0,0,0,0,30
"2020-03-13","Oregon",5,337,157,0,0,524,367,41,0,0,51,11,62,30
"2020-03-12","Oregon",3,286,62,0,0,367,305,41,0,0,0,0,0,19
"2020-03-11","Oregon",3,286,62,0,0,367,305,41,0,0,73,4,77,19
"2020-03-10","Oregon",3,213,67,0,0,295,228,41,0,0,48,1,49,15
"2020-03-09","Oregon",3,165,52,0,0,231,179,41,0,0,65,0,65,14
"2020-03-08","Oregon",3,100,53,0,0,167,114,41,0,0,23,7,30,14
"2020-03-07","Oregon",2,77,40,0,0,124,84,41,0,0,13,4,17,7
"2020-03-06","Oregon",2,64,28,0,0,95,67,41,0,0,19,0,19,3
"2020-03-05","Oregon",2,45,13,0,0,61,48,41,0,0,16,0,16,3
"2020-03-04","Oregon",2,29,18,0,0,50,32,41,0,0,0,0,0,3
"2020-03-03","Oregon",2,0,0,0,0,0,0,0,0,0,0,0,0,0
"2020-03-02","Oregon",2,0,0,0,0,0,0,0,0,0,0,0,0,0
"2020-03-01","Oregon",2,0,0,0,0,0,0,0,0,0,0,0,0,0
"2020-02-29","Oregon",2,0,0,0,0,0,0,0,0,0,0,0,0,0
"2020-02-28","Oregon",2,0,0,0,0,0,0,0,0,0,0,0,0,0
"2020-04-09","Pennsylvania",74,87374,0,0,338,105602,105602,42,29,0,5075,1989,7064,18228
"2020-04-08","Pennsylvania",72,82299,0,0,309,98538,98538,42,69,0,5580,1680,7260,16239
"2020-04-07","Pennsylvania",70,76719,0,0,240,91278,91278,42,78,0,5845,1579,7424,14559
"2020-04-06","Pennsylvania",68,70874,0,1145,162,83854,83854,42,12,73,4613,1470,6083,12980
"2020-04-05","Pennsylvania",67,66261,0,1072,150,77771,77771,42,14,68,6248,1493,7741,11510
"2020-04-04","Pennsylvania",66,60013,0,1004,136,70030,70030,42,34,152,6318,1597,7915,10017
"2020-04-03","Pennsylvania",59,53695,0,852,102,62115,62115,42,12,122,5997,1404,7401,8420
"2020-04-02","Pennsylvania",54,47698,0,730,90,54714,54714,42,16,110,5271,1211,6482,7016
"2020-04-01","Pennsylvania",49,42427,0,620,74,48232,48232,42,11,106,4782,962,5744,5805
"2020-03-31","Pennsylvania",45,37645,0,514,63,42488,42488,42,14,128,3868,756,4624,4843
"2020-03-30","Pennsylvania",42,33777,0,386,49,37864,37864,42,11,33,3716,693,4409,4087
"2020-03-29","Pennsylvania",39,30061,0,353,38,33455,33455,42,4,37,4807,643,5450,3394
"2020-03-28","Pennsylvania",37,25254,0,316,34,28005,28005,42,12,75,4238,533,4771,2751
"2020-03-27","Pennsylvania",34,21016,0,241,22,23234,23234,42,6,241,4575,531,5106,2218
"2020-03-26","Pennsylvania",32,16441,0,0,16,18128,18128,42,5,0,5248,560,5808,1687
"2020-03-25","Pennsylvania",30,11193,0,0,11,12320,12320,42,4,0,2550,276,2826,1127
"2020-03-24","Pennsylvania",27,8643,0,0,7,9494,9494,42,1,0,2048,207,2255,851
"2020-03-23","Pennsylvania",22,6595,0,0,6,7239,7239,42,4,0,1631,165,1796,644
"2020-03-22","Pennsylvania",19,4964,0,0,2,5443,5443,42,0,0,1198,108,1306,479
"2020-03-21","Pennsylvania",17,3766,0,0,2,4137,4137,42,1,0,1192,103,1295,371
"2020-03-20","Pennsylvania",15,2574,0,0,1,2842,2842,42,0,0,966,83,1049,268
"2020-03-19","Pennsylvania",13,1608,0,0,1,1793,1793,42,0,0,421,52,473,185
"2020-03-18","Pennsylvania",12,1187,0,0,1,1320,1320,42,1,0,308,37,345,133
"2020-03-17","Pennsylvania",11,879,0,0,0,975,975,42,0,0,209,20,229,96
"2020-03-16","Pennsylvania",9,670,0,0,0,746,746,42,0,0,465,13,478,76
"2020-03-15","Pennsylvania",8,205,183,0,0,451,268,42,0,0,0,16,16,63
"2020-03-14","Pennsylvania",6,205,150,0,0,402,252,42,0,0,65,6,71,47
"2020-03-13","Pennsylvania",6,140,130,0,0,311,181,42,0,0,24,19,43,41
"2020-03-12","Pennsylvania",4,116,81,0,0,219,138,42,0,0,28,6,34,22
"2020-03-11","Pennsylvania",3,88,54,0,0,158,104,42,0,0,88,4,92,16
"2020-03-10","Pennsylvania",3,0,0,0,0,12,12,42,0,0,0,2,2,12
"2020-03-09","Pennsylvania",3,0,0,0,0,10,10,42,0,0,0,4,4,10
"2020-03-08","Pennsylvania",2,0,0,0,0,6,6,42,0,0,0,2,2,6
"2020-03-07","Pennsylvania",2,0,0,0,0,4,4,42,0,0,0,2,2,4
"2020-03-06","Pennsylvania",2,0,0,0,0,2,2,42,0,0,0,0,0,2
"2020-03-05","Pennsylvania",2,0,0,0,0,0,0,0,0,0,0,0,0,0
"2020-03-04","Pennsylvania",2,0,0,0,0,0,0,0,0,0,0,0,0,0
"2020-03-03","Pennsylvania",2,0,0,0,0,0,0,0,0,0,0,0,0,0
"2020-03-02","Pennsylvania",2,0,0,0,0,0,0,0,0,0,0,0,0,0
"2020-03-01","Pennsylvania",2,0,0,0,0,0,0,0,0,0,0,0,0,0
"2020-02-29","Pennsylvania",2,0,0,0,0,0,0,0,0,0,0,0,0,0
"2020-02-28","Pennsylvania",2,0,0,0,0,0,0,0,0,0,0,0,0,0
"2020-04-09","Rhode Island",32,10682,0,0,43,12409,12409,44,8,0,0,277,277,1727
"2020-04-08","Rhode Island",31,10682,0,0,35,12132,12132,44,5,0,1605,220,1825,1450
"2020-04-07","Rhode Island",30,9077,0,0,30,10307,10307,44,3,0,1678,148,1826,1230
"2020-04-06","Rhode Island",30,7399,0,0,27,8481,8481,44,2,0,1140,160,1300,1082
"2020-04-05","Rhode Island",28,6259,0,0,25,7181,7181,44,8,0,675,116,791,922
"2020-04-04","Rhode Island",26,5584,0,0,17,6390,6390,44,3,0,727,97,824,806
"2020-04-03","Rhode Island",24,4857,0,0,14,5566,5566,44,2,0,445,52,497,709
"2020-04-02","Rhode Island",23,4412,0,0,12,5069,5069,44,2,0,581,91,672,657
"2020-04-01","Rhode Island",21,3831,0,0,10,4397,4397,44,2,0,355,77,432,566
"2020-03-31","Rhode Island",19,3476,0,0,8,3965,3965,44,4,0,289,87,376,489
"2020-03-30","Rhode Island",18,3187,0,0,4,3589,3589,44,1,0,347,108,455,402
"2020-03-29","Rhode Island",15,2840,0,0,3,3134,3134,44,3,0,299,55,354,294
"2020-03-28","Rhode Island",14,2541,138,0,0,2918,2780,44,0,0,235,36,271,239
"2020-03-27","Rhode Island",14,2306,138,0,0,2647,2509,44,0,0,1044,38,1082,203
"2020-03-26","Rhode Island",13,1262,181,0,0,1608,1427,44,0,0,0,33,33,165
"2020-03-25","Rhode Island",12,1262,196,0,0,1590,1394,44,0,0,62,8,70,132
"2020-03-24","Rhode Island",12,1200,77,0,0,1401,1324,44,0,0,57,18,75,124
"2020-03-23","Rhode Island",12,1143,216,0,0,1465,1249,44,0,0,211,23,234,106
"2020-03-22","Rhode Island",10,932,216,0,0,1231,1015,44,0,0,70,17,87,83
"2020-03-21","Rhode Island",8,862,290,0,0,1218,928,44,0,0,62,12,74,66
"2020-03-20","Rhode Island",7,800,140,0,0,994,854,44,0,0,146,10,156,54
"2020-03-19","Rhode Island",6,654,334,0,0,1032,698,44,0,0,114,11,125,44
"2020-03-18","Rhode Island",5,540,334,0,0,907,573,44,0,0,137,10,147,33
"2020-03-17","Rhode Island",4,403,149,0,0,575,426,44,0,0,95,2,97,23
"2020-03-16","Rhode Island",4,308,149,0,0,478,329,44,0,0,37,1,38,21
"2020-03-15","Rhode Island",4,271,57,0,0,348,291,44,0,0,73,0,73,20
"2020-03-14","Rhode Island",4,198,57,0,0,275,218,44,0,0,56,6,62,20
"2020-03-13","Rhode Island",3,142,29,0,0,185,156,44,0,0,48,9,57,14
"2020-03-12","Rhode Island",2,94,8,0,0,107,99,44,0,0,0,0,0,5
"2020-03-11","Rhode Island",2,94,24,0,0,123,99,44,0,0,36,2,38,5
"2020-03-10","Rhode Island",2,58,6,0,0,67,61,44,0,0,28,0,28,3
"2020-03-09","Rhode Island",2,30,6,0,0,39,33,44,0,0,0,0,0,3
"2020-03-08","Rhode Island",2,30,12,0,0,45,33,44,0,0,0,1,1,3
"2020-03-07","Rhode Island",2,30,0,0,0,32,32,44,0,0,13,-1,12,2
"2020-03-06","Rhode Island",2,17,0,0,0,20,20,44,0,0,0,1,1,3
"2020-03-05","Rhode Island",2,17,0,0,0,19,19,44,0,0,6,0,6,2
"2020-03-04","Rhode Island",2,11,0,0,0,13,13,44,0,0,5,0,5,2
"2020-03-03","Rhode Island",2,6,0,0,0,8,8,44,0,0,6,1,7,2
"2020-03-02","Rhode Island",2,0,0,0,0,1,1,44,0,0,0,0,0,1
"2020-03-01","Rhode Island",2,0,0,0,0,1,1,44,0,0,0,0,0,1
"2020-02-29","Rhode Island",2,0,0,0,0,0,0,0,0,0,0,0,0,0
"2020-02-28","Rhode Island",2,0,0,0,0,0,0,0,0,0,0,0,0,0
"2020-04-09","South Carolina",37,24575,0,241,67,27367,27367,45,4,0,2493,240,2733,2792
"2020-04-08","South Carolina",36,22082,0,241,63,24634,24634,45,12,0,819,135,954,2552
"2020-04-07","South Carolina",35,21263,0,241,51,23680,23680,45,7,0,4336,368,4704,2417
"2020-04-06","South Carolina",34,16927,0,241,44,18976,18976,45,0,0,0,0,0,2049
"2020-04-05","South Carolina",34,16927,0,241,44,18976,18976,45,4,0,530,132,662,2049
"2020-04-04","South Carolina",33,16397,0,241,40,18314,18314,45,9,0,10956,363,11319,1917
"2020-04-03","South Carolina",32,5441,0,241,31,6995,6995,45,0,-655,0,0,0,1554
"2020-04-02","South Carolina",32,5441,0,896,31,6995,6995,45,5,547,408,261,669,1554
"2020-04-01","South Carolina",31,5033,0,349,26,6326,6326,45,4,90,417,210,627,1293
"2020-03-31","South Carolina",30,4616,0,259,22,5699,5699,45,4,130,456,158,614,1083
"2020-03-30","South Carolina",28,4160,0,129,18,5085,5085,45,2,0,1145,151,1296,925
"2020-03-29","South Carolina",25,3015,0,129,16,3789,3789,45,3,0,607,235,842,774
"2020-03-28","South Carolina",20,2408,0,129,13,2947,2947,45,4,20,101,83,184,539
"2020-03-27","South Carolina",19,2307,0,109,9,2763,2763,45,0,0,0,0,0,456
"2020-03-26","South Carolina",19,2307,0,109,9,2763,2763,45,2,7,4,32,36,456
"2020-03-25","South Carolina",18,2303,0,102,7,2727,2727,45,2,102,291,126,417,424
"2020-03-24","South Carolina",15,2012,0,0,5,2310,2310,45,0,0,546,-1,545,298
"2020-03-23","South Carolina",15,1466,0,0,5,1765,1765,45,2,0,0,104,104,299
"2020-03-22","South Carolina",13,1466,0,0,3,1661,1661,45,2,0,211,43,254,195
"2020-03-21","South Carolina",13,1255,0,0,1,1407,1407,45,0,0,422,71,493,152
"2020-03-20","South Carolina",10,833,0,0,1,914,914,45,0,0,250,21,271,81
"2020-03-19","South Carolina",8,583,0,0,1,643,643,45,0,0,0,0,0,60
"2020-03-18","South Carolina",8,583,0,0,1,643,643,45,0,0,272,27,299,60
"2020-03-17","South Carolina",5,311,0,0,1,344,344,45,0,0,76,5,81,33
"2020-03-16","South Carolina",4,235,0,0,1,263,263,45,1,0,81,9,90,28
"2020-03-15","South Carolina",3,154,0,0,0,173,173,45,0,0,44,6,50,19
"2020-03-14","South Carolina",3,110,0,0,0,123,123,45,0,0,35,1,36,13
"2020-03-13","South Carolina",3,75,0,0,0,87,87,45,0,0,27,2,29,12
"2020-03-12","South Carolina",3,48,0,0,0,58,58,45,0,0,16,1,17,10
"2020-03-11","South Carolina",2,32,0,0,0,41,41,45,0,0,8,2,10,9
"2020-03-10","South Carolina",2,24,0,0,0,31,31,45,0,0,0,0,0,7
"2020-03-09","South Carolina",2,24,0,0,0,31,31,45,0,0,16,5,21,7
"2020-03-08","South Carolina",2,8,0,0,0,10,10,45,0,0,0,0,0,2
"2020-03-07","South Carolina",2,8,0,0,0,10,10,45,0,0,3,2,5,2
"2020-03-06","South Carolina",2,5,0,0,0,5,5,45,0,0,0,0,0,0
"2020-03-05","South Carolina",2,5,0,0,0,5,5,45,0,0,0,0,0,0
"2020-03-04","South Carolina",2,5,0,0,0,5,5,45,0,0,0,0,0,0
"2020-03-03","South Carolina",2,0,0,0,0,0,0,0,0,0,0,0,0,0
"2020-03-02","South Carolina",2,0,0,0,0,0,0,0,0,0,0,0,0,0
"2020-03-01","South Carolina",2,0,0,0,0,0,0,0,0,0,0,0,0,0
"2020-02-29","South Carolina",2,0,0,0,0,0,0,0,0,0,0,0,0,0
"2020-02-28","South Carolina",2,0,0,0,0,0,0,0,0,0,0,0,0,0
"2020-04-09","South Dakota",18,6700,0,27,6,7147,7147,46,0,1,345,54,399,447
"2020-04-08","South Dakota",17,6355,0,26,6,6748,6748,46,0,3,407,73,480,393
"2020-04-07","South Dakota",16,5948,2,23,6,6270,6268,46,2,0,216,32,248,320
"2020-04-06","South Dakota",15,5732,0,23,4,6020,6020,46,2,1,379,48,427,288
"2020-04-05","South Dakota",14,5353,0,22,2,5593,5593,46,0,3,341,28,369,240
"2020-04-04","South Dakota",14,5012,1,19,2,5225,5224,46,0,2,419,25,444,212
"2020-04-03","South Dakota",13,4593,3,17,2,4783,4780,46,0,0,376,22,398,187
"2020-04-02","South Dakota",13,4217,0,17,2,4382,4382,46,0,5,314,36,350,165
"2020-04-01","South Dakota",12,3903,0,12,2,4032,4032,46,1,0,294,21,315,129
"2020-03-31","South Dakota",12,3609,0,12,1,3717,3717,46,0,12,131,7,138,108
"2020-03-30","South Dakota",12,3478,0,0,1,3579,3579,46,0,0,351,11,362,101
"2020-03-29","South Dakota",11,3127,1,0,1,3218,3217,46,0,0,535,22,557,90
"2020-03-28","South Dakota",8,2592,0,0,1,2660,2660,46,0,0,205,10,215,68
"2020-03-27","South Dakota",7,2387,20,0,1,2465,2445,46,0,0,414,12,426,58
"2020-03-26","South Dakota",6,1973,125,0,1,2144,2019,46,0,0,1154,5,1159,46
"2020-03-25","South Dakota",6,819,268,0,1,1128,860,46,0,0,29,11,40,41
"2020-03-24","South Dakota",5,790,268,0,1,1088,820,46,0,0,28,2,30,30
"2020-03-23","South Dakota",4,762,265,0,1,1055,790,46,0,0,22,7,29,28
"2020-03-22","South Dakota",4,740,277,0,1,1038,761,46,0,0,49,7,56,21
"2020-03-21","South Dakota",3,691,268,0,1,973,705,46,0,0,28,0,28,14
"2020-03-20","South Dakota",3,663,270,0,1,947,677,46,0,0,112,3,115,14
"2020-03-19","South Dakota",3,551,385,0,1,947,562,46,0,0,0,0,0,11
"2020-03-18","South Dakota",3,551,350,0,1,912,562,46,1,0,0,0,0,11
"2020-03-17","South Dakota",3,551,35,0,0,597,562,46,0,0,57,1,58,11
"2020-03-16","South Dakota",3,494,0,0,0,504,504,46,0,0,167,1,168,10
"2020-03-15","South Dakota",2,327,6,0,0,342,336,46,0,0,145,0,145,9
"2020-03-14","South Dakota",2,182,3,0,0,194,191,46,0,0,109,0,109,9
"2020-03-13","South Dakota",2,73,11,0,0,93,82,46,0,0,46,1,47,9
"2020-03-12","South Dakota",2,27,11,0,0,46,35,46,0,0,14,3,17,8
"2020-03-11","South Dakota",2,13,2,0,0,20,18,46,0,0,2,5,7,5
"2020-03-10","South Dakota",2,11,0,0,0,11,11,46,0,0,6,0,6,0
"2020-03-09","South Dakota",2,5,0,0,0,5,5,46,0,0,0,0,0,0
"2020-03-08","South Dakota",2,5,0,0,0,5,5,46,0,0,0,0,0,0
"2020-03-07","South Dakota",2,5,0,0,0,5,5,46,0,0,0,0,0,0
"2020-03-06","South Dakota",2,0,0,0,0,0,0,0,0,0,0,0,0,0
"2020-03-05","South Dakota",2,0,0,0,0,0,0,0,0,0,0,0,0,0
"2020-03-04","South Dakota",2,0,0,0,0,0,0,0,0,0,0,0,0,0
"2020-03-03","South Dakota",2,0,0,0,0,0,0,0,0,0,0,0,0,0
"2020-03-02","South Dakota",2,0,0,0,0,0,0,0,0,0,0,0,0,0
"2020-03-01","South Dakota",2,0,0,0,0,0,0,0,0,0,0,0,0,0
"2020-02-29","South Dakota",2,0,0,0,0,0,0,0,0,0,0,0,0,0
"2020-02-28","South Dakota",2,0,0,0,0,0,0,0,0,0,0,0,0,0
"2020-04-09","Tennessee",44,55215,0,505,94,59849,59849,47,15,56,2959,272,3231,4634
"2020-04-08","Tennessee",43,52256,0,449,79,56618,56618,47,7,41,3520,224,3744,4362
"2020-04-07","Tennessee",42,48736,0,408,72,52874,52874,47,7,56,5188,336,5524,4138
"2020-04-06","Tennessee",41,43548,0,352,65,47350,47350,47,21,24,1881,169,2050,3802
"2020-04-05","Tennessee",40,41667,0,328,44,45300,45300,47,1,17,3597,312,3909,3633
"2020-04-04","Tennessee",39,38070,0,311,43,41391,41391,47,6,18,3298,254,3552,3321
"2020-04-03","Tennessee",38,34772,0,293,37,37839,37839,47,5,30,3006,222,3228,3067
"2020-04-02","Tennessee",37,31766,0,263,32,34611,34611,47,8,63,1997,162,2159,2845
"2020-04-01","Tennessee",36,29769,0,200,24,32452,32452,47,1,25,4648,444,5092,2683
"2020-03-31","Tennessee",34,25121,0,175,23,27360,27360,47,10,27,3651,405,4056,2239
"2020-03-30","Tennessee",33,21470,0,148,13,23304,23304,47,6,15,2433,297,2730,1834
"2020-03-29","Tennessee",32,19037,0,133,7,20574,20574,47,1,15,2072,164,2236,1537
"2020-03-28","Tennessee",31,16965,0,118,6,18338,18338,47,0,15,2077,170,2247,1373
"2020-03-27","Tennessee",30,14888,0,103,6,16091,16091,47,3,27,936,246,1182,1203
"2020-03-26","Tennessee",29,13952,0,76,3,14909,14909,47,0,23,2940,173,3113,957
"2020-03-25","Tennessee",25,11012,0,53,3,11796,11796,47,1,53,495,117,612,784
"2020-03-24","Tennessee",23,10517,0,0,2,11184,11184,47,0,0,7245,52,7297,667
"2020-03-23","Tennessee",22,3272,0,0,2,3887,3887,47,2,0,0,110,110,615
"2020-03-22","Tennessee",20,3272,0,0,0,3777,3777,47,0,0,0,134,134,505
"2020-03-21","Tennessee",17,3272,0,0,0,3643,3643,47,0,0,2709,143,2852,371
"2020-03-20","Tennessee",14,563,0,0,0,791,791,47,0,0,214,74,288,228
"2020-03-19","Tennessee",13,349,0,0,0,503,503,47,0,0,0,56,56,154
"2020-03-18","Tennessee",11,349,0,0,0,447,447,47,0,0,19,25,44,98
"2020-03-17","Tennessee",9,330,0,0,0,403,403,47,0,0,60,21,81,73
"2020-03-16","Tennessee",7,270,0,0,0,322,322,47,0,0,113,13,126,52
"2020-03-15","Tennessee",5,157,0,0,0,196,196,47,0,0,27,7,34,39
"2020-03-14","Tennessee",5,130,0,0,0,162,162,47,0,0,14,6,20,32
"2020-03-13","Tennessee",4,116,0,0,0,142,142,47,0,0,37,8,45,26
"2020-03-12","Tennessee",3,79,0,0,0,97,97,47,0,0,29,11,40,18
"2020-03-11","Tennessee",2,50,0,0,0,57,57,47,0,0,50,0,50,7
"2020-03-10","Tennessee",2,0,0,0,0,7,7,47,0,0,0,4,4,7
"2020-03-09","Tennessee",2,0,0,0,0,3,3,47,0,0,0,0,0,3
"2020-03-08","Tennessee",2,0,0,0,0,3,3,47,0,0,0,2,2,3
"2020-03-07","Tennessee",2,0,0,0,0,1,1,47,0,0,0,0,0,1
"2020-03-06","Tennessee",2,0,0,0,0,1,1,47,0,0,0,0,0,1
"2020-03-05","Tennessee",2,0,0,0,0,1,1,47,0,0,0,0,0,1
"2020-03-04","Tennessee",2,0,0,0,0,0,0,0,0,0,0,0,0,0
"2020-03-03","Tennessee",2,0,0,0,0,0,0,0,0,0,0,0,0,0
"2020-03-02","Tennessee",2,0,0,0,0,0,0,0,0,0,0,0,0,0
"2020-03-01","Tennessee",2,0,0,0,0,0,0,0,0,0,0,0,0,0
"2020-02-29","Tennessee",2,0,0,0,0,0,0,0,0,0,0,0,0,0
"2020-02-28","Tennessee",2,0,0,0,0,0,0,0,0,0,0,0,0,0
"2020-04-09","Texas",66,95904,0,0,199,106134,106134,48,22,0,8999,877,9876,10230
"2020-04-08","Texas",63,86905,0,0,177,96258,96258,48,23,0,6518,1091,7609,9353
"2020-04-07","Texas",59,80387,0,0,154,88649,88649,48,14,0,2306,986,3292,8262
"2020-04-06","Texas",55,78081,0,0,140,85357,85357,48,13,0,13955,464,14419,7276
"2020-04-05","Texas",53,64126,0,0,127,70938,70938,48,22,0,6485,702,7187,6812
"2020-04-04","Texas",50,57641,0,0,105,63751,63751,48,15,0,7207,780,7987,6110
"2020-04-03","Texas",47,50434,0,0,90,55764,55764,48,20,0,4424,661,5085,5330
"2020-04-02","Texas",44,46010,0,0,70,50679,50679,48,12,0,2150,672,2822,4669
"2020-04-01","Texas",41,43860,0,0,58,47857,47857,48,17,0,4134,731,4865,3997
"2020-03-31","Texas",39,39726,0,0,41,42992,42992,48,7,0,6723,389,7112,3266
"2020-03-30","Texas",37,33003,0,0,34,35880,35880,48,0,0,9795,325,10120,2877
"2020-03-29","Texas",36,23208,0,0,34,25760,25760,48,7,0,0,500,500,2552
"2020-03-28","Texas",34,23208,0,0,27,25260,25260,48,4,0,1273,321,1594,2052
"2020-03-27","Texas",32,21935,0,0,23,23666,23666,48,5,0,1907,335,2242,1731
"2020-03-26","Texas",31,20028,0,0,18,21424,21424,48,6,0,7508,422,7930,1396
"2020-03-25","Texas",29,12520,0,0,12,13494,13494,48,3,0,1763,564,2327,974
"2020-03-24","Texas",18,10757,0,0,9,11167,11167,48,1,0,1054,58,1112,410
"2020-03-23","Texas",17,9703,0,0,8,10055,10055,48,3,0,1281,18,1299,352
"2020-03-22","Texas",16,8422,0,0,5,8756,8756,48,0,0,2204,30,2234,334
"2020-03-21","Texas",16,6218,0,0,5,6522,6522,48,0,0,1135,110,1245,304
"2020-03-20","Texas",13,5083,0,0,5,5277,5277,48,2,0,2871,51,2922,194
"2020-03-19","Texas",12,2212,0,0,3,2355,2355,48,1,0,388,60,448,143
"2020-03-18","Texas",10,1824,0,0,2,1907,1907,48,1,0,620,19,639,83
"2020-03-17","Texas",8,1204,0,0,1,1268,1268,48,1,0,1204,7,1211,64
"2020-03-16","Texas",7,0,0,0,0,57,57,48,0,0,0,1,1,57
"2020-03-15","Texas",7,0,0,0,0,56,56,48,0,0,0,5,5,56
"2020-03-14","Texas",7,0,0,0,0,51,51,48,0,0,0,12,12,51
"2020-03-13","Texas",5,0,0,0,0,39,39,48,0,0,0,16,16,39
"2020-03-12","Texas",4,0,0,0,0,23,23,48,0,0,0,2,2,23
"2020-03-11","Texas",4,0,0,0,0,21,21,48,0,0,0,8,8,21
"2020-03-10","Texas",3,0,0,0,0,13,13,48,0,0,0,1,1,13
"2020-03-09","Texas",3,0,0,0,0,12,12,48,0,0,0,4,4,12
"2020-03-08","Texas",2,0,0,0,0,8,8,48,0,0,0,0,0,8
"2020-03-07","Texas",2,0,0,0,0,8,8,48,0,0,0,3,3,8
"2020-03-06","Texas",2,0,0,0,0,5,5,48,0,0,0,4,4,5
"2020-03-05","Texas",2,0,0,0,0,1,1,48,0,0,0,0,0,1
"2020-03-04","Texas",2,0,0,0,0,1,1,48,0,0,0,0,0,1
"2020-03-03","Texas",2,0,0,0,0,0,0,0,0,0,0,0,0,0
"2020-03-02","Texas",2,0,0,0,0,0,0,0,0,0,0,0,0,0
"2020-03-01","Texas",2,0,0,0,0,0,0,0,0,0,0,0,0,0
"2020-02-29","Texas",2,0,0,0,0,0,0,0,0,0,0,0,0,0
"2020-02-28","Texas",2,0,0,0,0,0,0,0,0,0,0,0,0,0
"2020-04-09","Utah",33,36397,0,168,13,38373,38373,49,0,10,2127,130,2257,1976
"2020-04-08","Utah",33,34270,0,158,13,36116,36116,49,0,10,1361,108,1469,1846
"2020-04-07","Utah",32,32909,0,148,13,34647,34647,49,0,10,1190,63,1253,1738
"2020-04-06","Utah",32,31719,0,138,13,33394,33394,49,5,14,2432,70,2502,1675
"2020-04-05","Utah",32,29287,0,124,8,30892,30892,49,0,7,2672,177,2849,1605
"2020-04-04","Utah",31,26615,0,117,8,28043,28043,49,1,11,3613,182,3795,1428
"2020-04-03","Utah",30,23002,0,106,7,24248,24248,49,0,6,3011,172,3183,1246
"2020-04-02","Utah",30,19991,0,100,7,21065,21065,49,0,9,-164,62,-102,1074
"2020-04-01","Utah",30,20155,0,91,7,21167,21167,49,2,18,2529,125,2654,1012
"2020-03-31","Utah",27,17626,0,73,5,18513,18513,49,1,73,2429,81,2510,887
"2020-03-30","Utah",26,15197,0,0,4,16003,16003,49,2,0,1923,87,2010,806
"2020-03-29","Utah",24,13274,0,0,2,13993,13993,49,0,0,2564,117,2681,719
"2020-03-28","Utah",22,10710,0,0,2,11312,11312,49,0,0,1946,122,2068,602
"2020-03-27","Utah",19,8764,0,0,2,9244,9244,49,1,0,1456,78,1534,480
"2020-03-26","Utah",18,7308,0,0,1,7710,7710,49,0,0,817,56,873,402
"2020-03-25","Utah",16,6491,0,0,1,6837,6837,49,0,0,967,47,1014,346
"2020-03-24","Utah",15,5524,0,0,1,5823,5823,49,0,0,734,42,776,299
"2020-03-23","Utah",15,4790,0,0,1,5047,5047,49,0,0,1282,76,1358,257
"2020-03-22","Utah",13,3508,0,0,1,3689,3689,49,1,0,1084,45,1129,181
"2020-03-21","Utah",12,2424,0,0,0,2560,2560,49,0,0,389,24,413,136
"2020-03-20","Utah",12,2035,0,0,0,2147,2147,49,0,0,587,34,621,112
"2020-03-19","Utah",9,1448,0,0,0,1526,1526,49,0,0,1317,15,1332,78
"2020-03-18","Utah",8,131,0,0,0,194,194,49,0,0,0,12,12,63
"2020-03-17","Utah",7,131,0,0,0,182,182,49,0,0,0,12,12,51
"2020-03-16","Utah",5,131,0,0,0,170,170,49,0,0,0,11,11,39
"2020-03-15","Utah",4,131,0,0,0,159,159,49,0,0,0,22,22,28
"2020-03-14","Utah",2,131,0,0,0,137,137,49,0,0,0,0,0,6
"2020-03-13","Utah",2,131,0,0,0,137,137,49,0,0,0,2,2,6
"2020-03-12","Utah",2,131,0,0,0,135,135,49,0,0,131,2,133,4
"2020-03-11","Utah",2,0,0,0,0,2,2,49,0,0,0,0,0,2
"2020-03-10","Utah",2,0,0,0,0,2,2,49,0,0,0,1,1,2
"2020-03-09","Utah",2,0,0,0,0,1,1,49,0,0,0,0,0,1
"2020-03-08","Utah",2,0,0,0,0,1,1,49,0,0,0,0,0,1
"2020-03-07","Utah",2,0,0,0,0,1,1,49,0,0,0,0,0,1
"2020-03-06","Utah",2,0,0,0,0,0,0,0,0,0,0,0,0,0
"2020-03-05","Utah",2,0,0,0,0,0,0,0,0,0,0,0,0,0
"2020-03-04","Utah",2,0,0,0,0,0,0,0,0,0,0,0,0,0
"2020-03-03","Utah",2,0,0,0,0,0,0,0,0,0,0,0,0,0
"2020-03-02","Utah",2,0,0,0,0,0,0,0,0,0,0,0,0,0
"2020-03-01","Utah",2,0,0,0,0,0,0,0,0,0,0,0,0,0
"2020-02-29","Utah",2,0,0,0,0,0,0,0,0,0,0,0,0,0
"2020-02-28","Utah",2,0,0,0,0,0,0,0,0,0,0,0,0,0
"2020-04-09","Vermont",22,7553,0,0,23,8181,8181,50,0,0,409,23,432,628
"2020-04-08","Vermont",22,7144,0,50,23,7749,7749,50,0,5,590,30,620,605
"2020-04-07","Vermont",21,6554,0,45,23,7129,7129,50,0,0,464,32,496,575
"2020-04-06","Vermont",20,6090,0,45,23,6633,6633,50,1,0,20,31,51,543
"2020-04-05","Vermont",20,6070,0,45,22,6582,6582,50,2,0,687,51,738,512
"2020-04-04","Vermont",19,5383,0,45,20,5844,5844,50,3,0,544,72,616,461
"2020-04-03","Vermont",17,4839,0,45,17,5228,5228,50,0,0,128,51,179,389
"2020-04-02","Vermont",16,4711,0,45,17,5049,5049,50,1,0,537,17,554,338
"2020-04-01","Vermont",16,4174,0,45,16,4495,4495,50,3,9,217,28,245,321
"2020-03-31","Vermont",15,3957,0,36,13,4250,4250,50,1,18,283,37,320,293
"2020-03-30","Vermont",15,3674,0,18,12,3930,3930,50,0,0,208,21,229,256
"2020-03-29","Vermont",14,3466,0,18,12,3701,3701,50,0,0,1303,24,1327,235
"2020-03-28","Vermont",14,2163,0,18,12,2374,2374,50,2,0,86,27,113,211
"2020-03-27","Vermont",13,2077,0,18,10,2261,2261,50,1,18,227,26,253,184
"2020-03-26","Vermont",13,1850,0,0,9,2008,2008,50,1,0,261,35,296,158
"2020-03-25","Vermont",12,1589,0,0,8,1712,1712,50,1,0,149,28,177,123
"2020-03-24","Vermont",11,1440,0,0,7,1535,1535,50,2,0,334,20,354,95
"2020-03-23","Vermont",9,1106,0,0,5,1181,1181,50,3,0,0,23,23,75
"2020-03-22","Vermont",7,1106,0,0,2,1158,1158,50,0,0,327,23,350,52
"2020-03-21","Vermont",4,779,0,0,2,808,808,50,0,0,0,0,0,29
"2020-03-20","Vermont",4,779,0,0,2,808,808,50,2,0,134,7,141,29
"2020-03-19","Vermont",4,645,0,0,0,667,667,50,0,0,53,3,56,22
"2020-03-18","Vermont",3,592,0,0,0,611,611,50,0,0,97,9,106,19
"2020-03-17","Vermont",3,495,0,0,0,505,505,50,0,0,74,2,76,10
"2020-03-16","Vermont",2,421,0,0,0,429,429,50,0,0,73,4,77,8
"2020-03-15","Vermont",2,348,0,0,0,352,352,50,0,0,121,0,121,4
"2020-03-14","Vermont",2,227,0,0,0,231,231,50,0,0,85,2,87,4
"2020-03-13","Vermont",2,142,0,0,0,144,144,50,0,0,45,0,45,2
"2020-03-12","Vermont",2,97,0,0,0,99,99,50,0,0,35,1,36,2
"2020-03-11","Vermont",2,62,0,0,0,63,63,50,0,0,22,0,22,1
"2020-03-10","Vermont",2,40,0,0,0,41,41,50,0,0,6,0,6,1
"2020-03-09","Vermont",2,34,0,0,0,35,35,50,0,0,6,0,6,1
"2020-03-08","Vermont",2,28,0,0,0,29,29,50,0,0,12,1,13,1
"2020-03-07","Vermont",2,16,0,0,0,16,16,50,0,0,8,0,8,0
"2020-03-06","Vermont",2,8,0,0,0,8,8,50,0,0,0,0,0,0
"2020-03-05","Vermont",2,0,0,0,0,0,0,0,0,0,0,0,0,0
"2020-03-04","Vermont",2,0,0,0,0,0,0,0,0,0,0,0,0,0
"2020-03-03","Vermont",2,0,0,0,0,0,0,0,0,0,0,0,0,0
"2020-03-02","Vermont",2,0,0,0,0,0,0,0,0,0,0,0,0,0
"2020-03-01","Vermont",2,0,0,0,0,0,0,0,0,0,0,0,0,0
"2020-02-29","Vermont",2,0,0,0,0,0,0,0,0,0,0,0,0,0
"2020-02-28","Vermont",2,0,0,0,0,0,0,0,0,0,0,0,0,0
"2020-04-09","Virginia",42,28984,627,685,109,33653,33026,51,34,70,1984,397,2381,4042
"2020-04-08","Virginia",40,27000,0,615,75,30645,30645,51,12,52,1688,312,2000,3645
"2020-04-07","Virginia",39,25312,0,563,63,28645,28645,51,9,66,3669,455,4124,3333
"2020-04-06","Virginia",37,21643,0,497,54,24521,24521,51,3,66,609,241,850,2878
"2020-04-05","Virginia",36,21034,0,431,51,23671,23671,51,-1,41,1889,230,2119,2637
"2020-04-04","Virginia",35,19145,0,390,52,21552,21552,51,6,78,2152,395,2547,2407
"2020-04-03","Virginia",34,16993,0,312,46,19005,19005,51,5,7,1110,306,1416,2012
"2020-04-02","Virginia",32,15883,0,305,41,17589,17589,51,7,0,2023,222,2245,1706
"2020-04-01","Virginia",31,13860,0,305,34,15344,15344,51,7,140,1709,234,1943,1484
"2020-03-31","Virginia",31,12151,0,165,27,13401,13401,51,2,29,1133,230,1363,1250
"2020-03-30","Virginia",30,11018,0,136,25,12038,12038,51,3,24,1299,130,1429,1020
"2020-03-29","Virginia",27,9719,0,112,22,10609,10609,51,5,13,1292,151,1443,890
"2020-03-28","Virginia",24,8427,0,99,17,9166,9166,51,3,16,1694,135,1829,739
"2020-03-27","Virginia",22,6733,0,83,14,7337,7337,51,1,18,1004,144,1148,604
"2020-03-26","Virginia",19,5729,0,65,13,6189,6189,51,4,6,750,69,819,460
"2020-03-25","Virginia",17,4979,0,59,9,5370,5370,51,2,14,799,101,900,391
"2020-03-24","Virginia",15,4180,0,45,7,4470,4470,51,1,7,737,36,773,290
"2020-03-23","Virginia",15,3443,0,38,6,3697,3697,51,3,6,325,35,360,254
"2020-03-22","Virginia",14,3118,0,32,3,3337,3337,51,1,7,480,67,547,219
"2020-03-21","Virginia",13,2638,0,25,2,2790,2790,51,0,25,427,38,465,152
"2020-03-20","Virginia",12,2211,0,0,2,2325,2325,51,0,0,382,20,402,114
"2020-03-19","Virginia",11,1829,0,0,2,1923,1923,51,1,0,628,17,645,94
"2020-03-18","Virginia",9,1201,0,0,1,1278,1278,51,0,0,240,10,250,77
"2020-03-17","Virginia",8,961,0,0,1,1028,1028,51,0,0,523,16,539,67
"2020-03-16","Virginia",7,438,0,0,1,489,489,51,0,0,75,6,81,51
"2020-03-15","Virginia",6,363,0,0,1,408,408,51,1,0,246,15,261,45
"2020-03-14","Virginia",5,117,0,0,0,147,147,51,0,0,0,0,0,30
"2020-03-13","Virginia",5,117,0,0,0,147,147,51,0,0,0,13,13,30
"2020-03-12","Virginia",3,117,0,0,0,134,134,51,0,0,57,8,65,17
"2020-03-11","Virginia",2,60,0,0,0,69,69,51,0,0,7,1,8,9
"2020-03-10","Virginia",2,53,0,0,0,61,61,51,0,0,15,5,20,8
"2020-03-09","Virginia",2,38,9,0,0,50,41,51,0,0,2,1,3,3
"2020-03-08","Virginia",2,36,6,0,0,44,38,51,0,0,5,2,7,2
"2020-03-07","Virginia",2,31,7,0,0,38,31,51,0,0,10,0,10,0
"2020-03-06","Virginia",2,21,10,0,0,31,21,51,0,0,3,0,3,0
"2020-03-05","Virginia",2,18,3,0,0,21,18,51,0,0,0,0,0,0
"2020-03-04","Virginia",2,0,0,0,0,0,0,0,0,0,0,0,0,0
"2020-03-03","Virginia",2,0,0,0,0,0,0,0,0,0,0,0,0,0
"2020-03-02","Virginia",2,0,0,0,0,0,0,0,0,0,0,0,0,0
"2020-03-01","Virginia",2,0,0,0,0,0,0,0,0,0,0,0,0,0
"2020-02-29","Virginia",2,0,0,0,0,0,0,0,0,0,0,0,0,0
"2020-02-28","Virginia",2,0,0,0,0,0,0,0,0,0,0,0,0,0
"2020-04-09","Washington",62,83391,0,0,421,92488,92488,53,27,0,0,0,0,9097
"2020-04-08","Washington",62,83391,0,0,394,92488,92488,53,19,0,0,0,0,9097
"2020-04-07","Washington",62,83391,0,0,375,92488,92488,53,12,0,0,337,337,9097
"2020-04-06","Washington",61,83391,0,0,363,92151,92151,53,10,0,3064,326,3390,8760
"2020-04-05","Washington",59,80327,0,0,353,88761,88761,53,13,0,4694,396,5090,8434
"2020-04-04","Washington",58,75633,0,0,340,83671,83671,53,20,0,2800,405,3205,8038
"2020-04-03","Washington",56,72833,0,254,320,80466,80466,53,24,0,4019,612,4631,7633
"2020-04-02","Washington",54,68814,0,254,296,75835,75835,53,26,0,8248,376,8624,7021
"2020-04-01","Washington",52,60566,0,254,270,67211,67211,53,18,0,0,597,597,6645
"2020-03-31","Washington",50,60566,0,254,252,66614,66614,53,13,0,0,482,482,6048
"2020-03-30","Washington",48,60566,0,254,239,66132,66132,53,11,0,5670,450,6120,5566
"2020-03-29","Washington",46,54896,0,254,228,60012,60012,53,17,0,5881,396,6277,5116
"2020-03-28","Washington",44,49015,0,254,211,53735,53735,53,20,254,5842,492,6334,4720
"2020-03-27","Washington",42,43173,0,0,191,47401,47401,53,14,0,11461,501,11962,4228
"2020-03-26","Washington",40,31712,0,0,177,35439,35439,53,22,0,0,468,468,3727
"2020-03-25","Washington",39,31712,0,0,155,34971,34971,53,13,0,0,449,449,3259
"2020-03-24","Washington",37,31712,0,0,142,34522,34522,53,9,0,2833,370,3203,2810
"2020-03-23","Washington",35,28879,0,0,133,31319,31319,53,11,0,3551,207,3758,2440
"2020-03-22","Washington",34,25328,0,0,122,27561,27561,53,14,0,3609,236,3845,2233
"2020-03-21","Washington",33,21719,0,0,108,23716,23716,53,6,0,2383,232,2615,1997
"2020-03-20","Washington",33,19336,0,0,102,21101,21101,53,11,0,3418,238,3656,1765
"2020-03-19","Washington",32,15918,0,0,91,17445,17445,53,10,0,2801,147,2948,1527
"2020-03-18","Washington",31,13117,0,0,81,14497,14497,53,4,0,1535,169,1704,1380
"2020-03-17","Washington",30,11582,0,0,77,12793,12793,53,9,0,2131,163,2294,1211
"2020-03-16","Washington",30,9451,0,0,68,10499,10499,53,12,0,2329,127,2456,1048
"2020-03-15","Washington",28,7122,0,0,56,8043,8043,53,5,0,1121,131,1252,921
"2020-03-14","Washington",25,6001,0,0,51,6791,6791,53,4,0,1651,99,1750,790
"2020-03-13","Washington",23,4350,0,0,47,5041,5041,53,3,0,1313,150,1463,691
"2020-03-12","Washington",20,3037,0,0,44,3578,3578,53,4,0,862,69,931,541
"2020-03-11","Washington",19,2175,0,0,40,2647,2647,53,3,0,1065,83,1148,472
"2020-03-10","Washington",17,1110,0,0,37,1499,1499,53,2,0,0,47,47,389
"2020-03-09","Washington",16,1110,0,0,35,1452,1452,53,4,0,470,97,567,342
"2020-03-08","Washington",14,640,60,0,31,945,885,53,4,0,270,65,335,245
"2020-03-07","Washington",13,370,66,0,27,616,550,53,1,0,0,31,31,180
"2020-03-06","Washington",12,370,0,0,26,519,519,53,6,0,370,53,423,149
"2020-03-05","Washington",11,0,0,0,20,96,96,53,4,0,0,20,20,96
"2020-03-04","Washington",9,0,0,0,16,76,76,53,2,0,0,18,18,76
"2020-03-03","Washington",7,0,0,0,14,58,58,53,3,0,0,24,24,58
"2020-03-02","Washington",5,0,0,0,11,34,34,53,3,0,0,4,4,34
"2020-03-01","Washington",5,0,0,0,8,30,30,53,3,0,0,12,12,30
"2020-02-29","Washington",3,0,0,0,5,18,18,53,1,0,0,9,9,18
"2020-02-28","Washington",2,0,0,0,4,9,9,53,0,0,0,0,0,9
"2020-04-09","West Virginia",20,13340,0,0,5,13863,13863,54,1,0,1257,61,1318,523
"2020-04-08","West Virginia",19,12083,0,0,4,12545,12545,54,0,0,436,50,486,462
"2020-04-07","West Virginia",18,11647,0,0,4,12059,12059,54,0,0,2052,67,2119,412
"2020-04-06","West Virginia",16,9595,0,0,4,9940,9940,54,1,0,1081,21,1102,345
"2020-04-05","West Virginia",16,8514,0,0,3,8838,8838,54,1,0,1110,42,1152,324
"2020-04-04","West Virginia",15,7404,0,0,2,7686,7686,54,0,0,1274,45,1319,282
"2020-04-03","West Virginia",14,6130,0,1,2,6367,6367,54,0,0,854,20,874,237
"2020-04-02","West Virginia",14,5276,0,1,2,5493,5493,54,1,0,892,26,918,217
"2020-04-01","West Virginia",13,4384,0,1,1,4575,4575,54,0,0,403,29,432,191
"2020-03-31","West Virginia",13,3981,0,1,1,4143,4143,54,0,0,997,36,1033,162
"2020-03-30","West Virginia",12,2984,0,1,1,3110,3110,54,1,0,279,13,292,126
"2020-03-29","West Virginia",12,2705,0,1,0,2818,2818,54,0,0,374,17,391,113
"2020-03-28","West Virginia",11,2331,6,1,0,2433,2427,54,0,0,552,20,572,96
"2020-03-27","West Virginia",9,1779,43,1,0,1898,1855,54,0,0,748,25,773,76
"2020-03-26","West Virginia",7,1031,19,1,0,1101,1082,54,0,0,272,12,284,51
"2020-03-25","West Virginia",5,759,6,1,0,804,798,54,0,0,149,19,168,39
"2020-03-24","West Virginia",4,610,0,1,0,630,630,54,0,0,166,4,170,20
"2020-03-23","West Virginia",3,444,4,1,0,464,460,54,0,0,59,4,63,16
"2020-03-22","West Virginia",3,385,1,1,0,398,397,54,0,0,55,1,56,12
"2020-03-21","West Virginia",3,330,2,1,0,343,341,54,0,1,111,4,115,11
"2020-03-20","West Virginia",2,219,13,0,0,239,226,54,0,0,76,5,81,7
"2020-03-19","West Virginia",2,143,3,0,0,148,145,54,0,0,21,1,22,2
"2020-03-18","West Virginia",2,122,14,0,0,137,123,54,0,0,42,1,43,1
"2020-03-17","West Virginia",2,80,4,0,0,84,80,54,0,0,0,0,0,0
"2020-03-16","West Virginia",2,80,4,0,0,84,80,54,0,0,42,0,42,0
"2020-03-15","West Virginia",2,38,1,0,0,39,38,54,0,0,12,0,12,0
"2020-03-14","West Virginia",2,26,5,0,0,31,26,54,0,0,9,0,9,0
"2020-03-13","West Virginia",2,17,4,0,0,21,17,54,0,0,10,0,10,0
"2020-03-12","West Virginia",2,7,1,0,0,8,7,54,0,0,4,0,4,0
"2020-03-11","West Virginia",2,3,2,0,0,5,3,54,0,0,1,0,1,0
"2020-03-10","West Virginia",2,2,3,0,0,5,2,54,0,0,0,0,0,0
"2020-03-09","West Virginia",2,2,3,0,0,5,2,54,0,0,0,0,0,0
"2020-03-08","West Virginia",2,2,3,0,0,5,2,54,0,0,0,0,0,0
"2020-03-07","West Virginia",2,2,3,0,0,5,2,54,0,0,1,0,1,0
"2020-03-06","West Virginia",2,1,4,0,0,5,1,54,0,0,0,0,0,0
"2020-03-05","West Virginia",2,0,0,0,0,0,0,0,0,0,0,0,0,0
"2020-03-04","West Virginia",2,0,0,0,0,0,0,0,0,0,0,0,0,0
"2020-03-03","West Virginia",2,0,0,0,0,0,0,0,0,0,0,0,0,0
"2020-03-02","West Virginia",2,0,0,0,0,0,0,0,0,0,0,0,0,0
"2020-03-01","West Virginia",2,0,0,0,0,0,0,0,0,0,0,0,0,0
"2020-02-29","West Virginia",2,0,0,0,0,0,0,0,0,0,0,0,0,0
"2020-02-28","West Virginia",2,0,0,0,0,0,0,0,0,0,0,0,0,0
"2020-04-09","Wisconsin",37,31424,0,843,111,34309,34309,55,12,53,1309,129,1438,2885
"2020-04-08","Wisconsin",37,30115,0,790,99,32871,32871,55,7,45,1603,178,1781,2756
"2020-04-07","Wisconsin",36,28512,0,745,92,31090,31090,55,15,77,1938,138,2076,2578
"2020-04-06","Wisconsin",35,26574,0,668,77,29014,29014,55,9,44,1405,173,1578,2440
"2020-04-05","Wisconsin",35,25169,0,624,68,27436,27436,55,12,36,1310,155,1465,2267
"2020-04-04","Wisconsin",34,23859,0,588,56,25971,25971,55,19,101,1482,200,1682,2112
"2020-04-03","Wisconsin",33,22377,0,487,37,24289,24289,55,6,26,2060,182,2242,1912
"2020-04-02","Wisconsin",32,20317,0,461,31,22047,22047,55,7,63,1498,180,1678,1730
"2020-04-01","Wisconsin",32,18819,0,398,24,20369,20369,55,8,61,1444,199,1643,1550
"2020-03-31","Wisconsin",31,17375,0,337,16,18726,18726,55,2,337,1519,130,1649,1351
"2020-03-30","Wisconsin",30,15856,0,0,14,17077,17077,55,1,0,-694,109,-585,1221
"2020-03-29","Wisconsin",30,16550,0,0,13,17662,17662,55,0,0,1318,123,1441,1112
"2020-03-28","Wisconsin",29,15232,0,0,13,16221,16221,55,0,0,2092,147,2239,989
"2020-03-27","Wisconsin",26,13140,0,0,13,13982,13982,55,5,0,1557,135,1692,842
"2020-03-26","Wisconsin",24,11583,0,0,8,12290,12290,55,1,0,1494,122,1616,707
"2020-03-25","Wisconsin",21,10089,0,0,7,10674,10674,55,2,0,1852,128,1980,585
"2020-03-24","Wisconsin",19,8237,0,0,5,8694,8694,55,0,0,1187,41,1228,457
"2020-03-23","Wisconsin",18,7050,0,0,5,7466,7466,55,1,0,820,31,851,416
"2020-03-22","Wisconsin",17,6230,0,0,4,6615,6615,55,0,0,1602,104,1706,385
"2020-03-21","Wisconsin",15,4628,0,0,4,4909,4909,55,1,0,1173,75,1248,281
"2020-03-20","Wisconsin",14,3455,0,0,3,3661,3661,55,3,0,1263,51,1314,206
"2020-03-19","Wisconsin",13,2192,0,0,0,2347,2347,55,0,0,615,49,664,155
"2020-03-18","Wisconsin",12,1577,0,0,0,1683,1683,55,0,0,539,34,573,106
"2020-03-17","Wisconsin",9,1038,0,0,0,1110,1110,55,0,0,534,25,559,72
"2020-03-16","Wisconsin",6,504,0,0,0,551,551,55,0,0,191,14,205,47
"2020-03-15","Wisconsin",5,313,0,0,0,346,346,55,0,0,144,14,158,33
"2020-03-14","Wisconsin",3,169,0,0,0,188,188,55,0,0,0,0,0,19
"2020-03-13","Wisconsin",3,169,0,0,0,188,188,55,0,0,85,11,96,19
"2020-03-12","Wisconsin",2,84,0,0,0,92,92,55,0,0,41,5,46,8
"2020-03-11","Wisconsin",2,43,0,0,0,46,46,55,0,0,7,1,8,3
"2020-03-10","Wisconsin",2,36,0,0,0,38,38,55,0,0,0,1,1,2
"2020-03-09","Wisconsin",2,36,0,0,0,37,37,55,0,0,5,0,5,1
"2020-03-08","Wisconsin",2,31,12,0,0,44,32,55,0,0,0,0,0,1
"2020-03-07","Wisconsin",2,31,12,0,0,44,32,55,0,0,0,0,0,1
"2020-03-06","Wisconsin",2,31,12,0,0,44,32,55,0,0,12,0,12,1
"2020-03-05","Wisconsin",2,19,6,0,0,26,20,55,0,0,0,0,0,1
"2020-03-04","Wisconsin",2,19,6,0,0,26,20,55,0,0,0,0,0,1
"2020-03-03","Wisconsin",2,0,0,0,0,0,0,0,0,0,0,0,0,0
"2020-03-02","Wisconsin",2,0,0,0,0,0,0,0,0,0,0,0,0,0
"2020-03-01","Wisconsin",2,0,0,0,0,0,0,0,0,0,0,0,0,0
"2020-02-29","Wisconsin",2,0,0,0,0,0,0,0,0,0,0,0,0,0
"2020-02-28","Wisconsin",2,0,0,0,0,0,0,0,0,0,0,0,0,0
"2020-04-09","Wyoming",14,3920,0,34,0,4150,4150,56,0,1,77,9,86,230
"2020-04-08","Wyoming",14,3843,0,33,0,4064,4064,56,0,0,54,5,59,221
"2020-04-07","Wyoming",14,3789,0,33,0,4005,4005,56,0,10,70,6,76,216
"2020-04-06","Wyoming",14,3719,0,23,0,3929,3929,56,0,0,679,13,692,210
"2020-04-05","Wyoming",13,3040,0,23,0,3237,3237,56,0,0,95,10,105,197
"2020-04-04","Wyoming",13,2945,0,23,0,3132,3132,56,0,2,241,25,266,187
"2020-04-03","Wyoming",13,2704,0,21,0,2866,2866,56,0,2,265,12,277,162
"2020-04-02","Wyoming",13,2439,0,19,0,2589,2589,56,0,1,221,20,241,150
"2020-04-01","Wyoming",12,2218,0,18,0,2348,2348,56,0,1,219,21,240,130
"2020-03-31","Wyoming",12,1999,0,17,0,2108,2108,56,0,0,159,15,174,109
"2020-03-30","Wyoming",11,1840,0,17,0,1934,1934,56,0,2,286,8,294,94
"2020-03-29","Wyoming",10,1554,0,15,0,1640,1640,56,0,1,79,4,83,86
"2020-03-28","Wyoming",10,1475,0,14,0,1557,1557,56,0,3,264,12,276,82
"2020-03-27","Wyoming",9,1211,0,11,0,1281,1281,56,0,11,159,17,176,70
"2020-03-26","Wyoming",7,1052,0,0,0,1105,1105,56,0,0,98,9,107,53
"2020-03-25","Wyoming",6,954,0,0,0,998,998,56,0,0,244,15,259,44
"2020-03-24","Wyoming",4,710,0,0,0,739,739,56,0,0,118,3,121,29
"2020-03-23","Wyoming",4,592,0,0,0,618,618,56,0,0,154,2,156,26
"2020-03-22","Wyoming",4,438,0,0,0,462,462,56,0,0,0,1,1,24
"2020-03-21","Wyoming",4,438,0,0,0,461,461,56,0,0,107,4,111,23
"2020-03-20","Wyoming",3,331,0,0,0,350,350,56,0,0,60,1,61,19
"2020-03-19","Wyoming",3,271,0,0,0,289,289,56,0,0,93,3,96,18
"2020-03-18","Wyoming",3,178,0,0,0,193,193,56,0,0,83,5,88,15
"2020-03-17","Wyoming",3,95,0,0,0,105,105,56,0,0,95,7,102,10
"2020-03-16","Wyoming",2,0,0,0,0,3,3,56,0,0,0,0,0,3
"2020-03-15","Wyoming",2,0,0,0,0,3,3,56,0,0,0,1,1,3
"2020-03-14","Wyoming",2,0,0,0,0,2,2,56,0,0,0,1,1,2
"2020-03-13","Wyoming",2,0,0,0,0,1,1,56,0,0,0,0,0,1
"2020-03-12","Wyoming",2,0,0,0,0,1,1,56,0,0,0,1,1,1
"2020-03-11","Wyoming",2,0,0,0,0,0,0,56,0,0,0,0,0,0
"2020-03-10","Wyoming",2,0,0,0,0,0,0,56,0,0,0,0,0,0
"2020-03-09","Wyoming",2,0,0,0,0,0,0,56,0,0,0,0,0,0
"2020-03-08","Wyoming",2,0,0,0,0,0,0,56,0,0,0,0,0,0
"2020-03-07","Wyoming",2,0,0,0,0,0,0,56,0,0,0,0,0,0
"2020-03-06","Wyoming",2,0,0,0,0,0,0,0,0,0,0,0,0,0
"2020-03-05","Wyoming",2,0,0,0,0,0,0,0,0,0,0,0,0,0
"2020-03-04","Wyoming",2,0,0,0,0,0,0,0,0,0,0,0,0,0
"2020-03-03","Wyoming",2,0,0,0,0,0,0,0,0,0,0,0,0,0
"2020-03-02","Wyoming",2,0,0,0,0,0,0,0,0,0,0,0,0,0
"2020-03-01","Wyoming",2,0,0,0,0,0,0,0,0,0,0,0,0,0
"2020-02-29","Wyoming",2,0,0,0,0,0,0,0,0,0,0,0,0,0
"2020-02-28","Wyoming",2,0,0,0,0,0,0,0,0,0,0,0,0,0
