"date","state","positive","negative","pending","hospitalized","death","total","fips","deathIncrease","hospitalizedIncrease","negativeIncrease","positiveIncrease","totalTestResultsIncrease","NA"
"2020-05-14","AK","387","31375","0","0","10","31762","31762","02","0","0","1109","4","1113"
"2020-05-14","AL","10968","131017","0","1350","467","141985","141985","01","18","33","5262","351","5613"
"2020-05-14","AR","4236","71582","0","509","97","75818","75818","05","2","12","2531","72","2603"
"2020-05-14","AS","0","105","0","0","0","105","105","60","0","0","0","0","0"
"2020-05-14","AZ","12674","121664","0","1636","624","134338","134338","04","30","46","6090","498","6588"
"2020-05-14","CA","73164","1031487","0","0","3032","1104651","1104651","06","98","0","37036","2023","39059"
"2020-05-14","CO","20475","94044","0","3735","1062","114519","114519","08","53","40","2951","318","3269"
"2020-05-14","CT","35464","114098","0","10946","3219","149562","149562","09","94","1557","6010","609","6619"
"2020-05-14","DC","6736","26263","0","0","358","32999","32999","11","8","0","1189","152","1341"
"2020-05-14","DE","7223","29634","0","0","260","36857","36857","10","13","0","1833","271","2104"
"2020-05-14","FL","43210","565627","1228","7993","1948","610065","608837","12","50","158","13266","808","14074"
"2020-05-14","GA","35858","250023","0","6345","1527","285881","285881","13","22","86","11451","526","11977"
"2020-05-14","GU","153","4226","0","0","5","4379","4379","66","0","0","116","1","117"
"2020-05-14","HI","638","38243","0","81","17","38881","38881","15","0","0","513","3","516"
"2020-05-14","IA","13675","75619","0","0","318","89294","89294","19","12","0","3189","386","3575"
"2020-05-14","ID","2324","31430","0","212","69","33754","33754","16","0","-2","595","31","626"
"2020-05-14","IL","87937","424100","0","0","3928","512037","512037","17","136","0","19439","3239","22678"
"2020-05-14","IN","26053","134186","0","4389","1646","160239","160239","18","27","0","5576","580","6156"
"2020-05-14","KS","7468","50160","0","704","164","57628","57628","20","0","0","0","0","0"
"2020-05-14","KY","7080","110315","0","1835","326","117395","117395","21","5","10","6534","227","6761"
"2020-05-14","LA","33489","214099","0","0","2417","247588","247588","22","36","0","8857","827","9684"
"2020-05-14","MA","80497","329535","0","8032","5315","410032","410032","25","0","0","0","0","0"
"2020-05-14","MD","35903","142551","0","6553","1866","178454","178454","24","57","149","3789","1091","4880"
"2020-05-14","ME","1565","22092","0","207","69","23657","23657","23","3","3","0","50","50"
"2020-05-14","MI","49582","286301","0","0","4787","335883","335883","26","73","0","26432","1191","27623"
"2020-05-14","MN","13435","115317","0","1915","663","128752","128752","27","25","64","6199","518","6717"
"2020-05-14","MO","10317","116793","0","0","562","127110","127110","29","20","0","2793","175","2968"
"2020-05-14","MP","19","3306","0","0","2","3325","3325","69","0","0","285","0","285"
"2020-05-14","MS","10483","94843","0","1667","480","105326","105326","28","15","51","4885","393","5278"
"2020-05-14","MT","462","24087","0","63","16","24549","24549","30","0","0","697","0","697"
"2020-05-14","NC","16507","202761","0","0","615","219268","219268","37","18","0","8120","691","8811"
"2020-05-14","ND","1647","48599","0","129","40","50246","50246","38","0","2","1301","0","1301"
"2020-05-14","NE","9075","44266","0","0","107","53341","53341","31","4","0","3233","383","3616"
"2020-05-14","NH","3299","35876","735","326","150","39910","39175","33","8","7","1899","60","1959"
"2020-05-14","NJ","142704","308992","0","0","9946","451696","451696","34","244","0","9102","1144","10246"
"2020-05-14","NM","5364","109647","0","886","231","115011","115011","35","12","0","4570","152","4722"
"2020-05-14","NV","6499","62985","0","0","331","69484","69484","32","10","0","2707","105","2812"
"2020-05-14","NY","343051","955706","0","74433","22170","1298757","1298757","36","157","470","37460","2390","39850"
"2020-05-14","OH","26357","206995","0","4718","1534","233352","233352","39","51","100","6862","636","7498"
"2020-05-14","OK","4962","107221","0","858","284","112183","112183","40","6","10","2946","110","3056"
"2020-05-14","OR","3479","80571","0","685","137","84050","84050","41","3","7","0","63","63"
"2020-05-14","PA","59636","251559","0","0","4218","311195","311195","42","275","0","7388","938","8326"
"2020-05-14","PR","2427","0","0","0","117","2427","2427","72","2","0","0","98","98"
"2020-05-14","RI","12016","89585","0","1351","468","101601","101601","44","6","23","3498","181","3679"
"2020-05-14","SC","8189","94346","0","1338","371","102535","102535","45","16","0","9133","262","9395"
"2020-05-14","SD","3792","22681","0","290","43","26473","26473","46","4","9","569","60","629"
"2020-05-14","TN","16699","285618","0","1435","287","302317","302317","47","14","47","9071","329","9400"
"2020-05-14","TX","43851","579433","0","0","1216","623284","623284","48","58","0","34405","1448","35853"
"2020-05-14","UT","6749","153370","0","558","75","160119","160119","49","0","5","3204","129","3333"
"2020-05-14","VA","27813","139017","496","5211","955","167326","166830","51","28","131","4371","1067","5438"
"2020-05-14","VI","69","1164","45","0","6","1278","1233","78","0","0","36","0","36"
"2020-05-14","VT","932","21573","0","0","53","22505","22505","50","0","0","826","3","829"
"2020-05-14","WA","17512","243568","0","0","975","261080","261080","53","13","0","4577","182","4759"
"2020-05-14","WI","11275","122598","169","1939","434","134042","133873","55","13","31","5487","373","5860"
"2020-05-14","WV","1427","67286","0","0","60","68713","68713","54","2","0","2004","29","2033"
"2020-05-14","WY","701","14729","0","67","7","15430","15430","56","0","0","345","26","371"
"2020-05-13","AK","383","30266","0","0","10","30649","30649","02","0","0","688","0","688"
"2020-05-13","AL","10617","125755","0","1317","449","136372","136372","01","20","30","2847","307","3154"
"2020-05-13","AR","4164","69051","0","497","95","73215","73215","05","0","12","2771","0","2771"
"2020-05-13","AS","0","105","0","0","0","105","105","60","0","0","0","0","0"
"2020-05-13","AZ","12176","115574","0","1590","594","127750","127750","04","32","26","4468","440","4908"
"2020-05-13","CA","71141","994451","0","0","2934","1065592","1065592","06","87","0","30463","1759","32222"
"2020-05-13","CO","20157","91093","0","3695","1009","111250","111250","08","22","32","2315","278","2593"
"2020-05-13","CT","34855","108088","0","9389","3125","142943","142943","09","84","0","3997","522","4519"
"2020-05-13","DC","6584","25074","0","0","350","31658","31658","11","14","0","509","99","608"
"2020-05-13","DE","6952","27801","0","0","247","34753","34753","10","10","0","1251","211","1462"
"2020-05-13","FL","42402","552361","1191","7835","1898","595954","594763","12","49","181","14680","479","15159"
"2020-05-13","GA","35332","238572","0","6259","1505","273904","273904","13","44","129","11028","697","11725"
"2020-05-13","GU","152","4110","0","0","5","4262","4262","66","0","0","171","0","171"
"2020-05-13","HI","635","37730","0","81","17","38365","38365","15","0","0","425","1","426"
"2020-05-13","IA","13289","72430","0","0","306","85719","85719","19","17","0","4054","377","4431"
"2020-05-13","ID","2293","30835","0","214","69","33128","33128","16","-1","4","390","33","423"
"2020-05-13","IL","84698","404661","0","0","3792","489359","489359","17","191","0","15991","1677","17668"
"2020-05-13","IN","25473","128610","0","4389","1619","154083","154083","18","41","0","3227","346","3573"
"2020-05-13","KS","7468","50160","0","704","164","57628","57628","20","6","44","3167","352","3519"
"2020-05-13","KY","6853","103781","0","1825","321","110634","110634","21","10","58","6434","176","6610"
"2020-05-13","LA","32662","205242","0","0","2381","237904","237904","22","34","0","9280","612","9892"
"2020-05-13","MA","80497","329535","0","8032","5315","410032","410032","25","174","190","7371","1165","8536"
"2020-05-13","MD","34812","138762","0","6404","1809","173574","173574","24","53","117","3320","751","4071"
"2020-05-13","ME","1515","22092","0","204","66","23607","23607","23","1","2","0","38","38"
"2020-05-13","MI","48391","259869","0","0","4714","308260","308260","26","40","0","0","370","370"
"2020-05-13","MN","12917","109118","0","1851","638","122035","122035","27","24","52","778","423","1201"
"2020-05-13","MO","10142","114000","0","0","542","124142","124142","29","18","0","2710","136","2846"
"2020-05-13","MP","19","3021","0","0","2","3040","3040","69","0","0","167","0","167"
"2020-05-13","MS","10090","89958","0","1616","465","100048","100048","28","8","34","2174","182","2356"
"2020-05-13","MT","462","23390","0","63","16","23852","23852","30","0","0","816","1","817"
"2020-05-13","NC","15816","194641","0","0","597","210457","210457","37","20","0","7743","470","8213"
"2020-05-13","ND","1647","47298","0","127","40","48945","48945","38","2","5","1037","76","1113"
"2020-05-13","NE","8692","41033","0","0","103","49725","49725","31","3","0","1662","120","1782"
"2020-05-13","NH","3239","33977","51","319","142","37267","37216","33","9","1","1576","79","1655"
"2020-05-13","NJ","141560","299890","0","0","9702","441450","441450","34","194","0","7573","817","8390"
"2020-05-13","NM","5212","105077","0","886","219","110289","110289","35","11","0","3425","143","3568"
"2020-05-13","NV","6394","60278","0","0","321","66672","66672","32","9","0","2514","83","2597"
"2020-05-13","NY","340661","918246","0","73963","22013","1258907","1258907","36","168","820","31618","2176","33794"
"2020-05-13","OH","25721","200133","0","4618","1483","225854","225854","39","47","79","7652","471","8123"
"2020-05-13","OK","4852","104275","0","848","278","109127","109127","40","0","20","12896","120","13016"
"2020-05-13","OR","3416","80571","0","678","134","83987","83987","41","4","5","6251","130","6381"
"2020-05-13","PA","58698","244171","0","0","3943","302869","302869","42","137","0","6182","707","6889"
"2020-05-13","PR","2329","0","0","0","115","2329","2329","72","1","0","0","30","30"
"2020-05-13","RI","11835","86087","0","1328","462","97922","97922","44","18","21","2462","221","2683"
"2020-05-13","SC","7927","85213","0","1338","355","93140","93140","45","0","0","0","0","0"
"2020-05-13","SD","3732","22112","0","281","39","25844","25844","46","0","10","578","69","647"
"2020-05-13","TN","16370","276547","0","1388","273","292917","292917","47","8","25","8834","259","9093"
"2020-05-13","TX","42403","545028","0","0","1158","587431","587431","48","25","0","47904","1355","49259"
"2020-05-13","UT","6620","150166","0","553","75","156786","156786","49","2","18","3113","188","3301"
"2020-05-13","VA","26746","134646","485","5080","927","161877","161392","51","36","151","5117","946","6063"
"2020-05-13","VI","69","1128","62","0","6","1259","1197","78","0","0","13","0","13"
"2020-05-13","VT","929","20747","0","0","53","21676","21676","50","0","0","412","2","414"
"2020-05-13","WA","17330","238991","0","0","962","256321","256321","53","17","0","4005","208","4213"
"2020-05-13","WI","10902","117111","194","1908","421","128207","128013","55","3","31","4363","291","4654"
"2020-05-13","WV","1398","65282","0","0","58","66680","66680","54","1","0","1584","27","1611"
"2020-05-13","WY","675","14384","0","67","7","15059","15059","56","0","0","0","0","0"
"2020-05-12","AK","383","29578","0","0","10","29961","29961","02","0","0","1279","2","1281"
"2020-05-12","AL","10310","122908","0","1287","429","133218","133218","01","28","31","3473","301","3774"
"2020-05-12","AR","4164","66280","0","485","95","70444","70444","05","1","5","1284","130","1414"
"2020-05-12","AS","0","105","0","0","0","105","105","60","0","0","0","0","0"
"2020-05-12","AZ","11736","111106","0","1564","562","122842","122842","04","20","27","6022","356","6378"
"2020-05-12","CA","69382","963988","0","0","2847","1033370","1033370","06","77","0","40030","1443","41473"
"2020-05-12","CO","19879","88778","0","3663","987","108657","108657","08","6","-26","-113","-20","-133"
"2020-05-12","CT","34333","104091","0","9389","3041","138424","138424","09","33","0","5348","568","5916"
"2020-05-12","DC","6485","24565","0","0","336","31050","31050","11","8","0","693","96","789"
"2020-05-12","DE","6741","26550","0","0","237","33291","33291","10","12","0","1187","176","1363"
"2020-05-12","FL","41923","537681","1064","7654","1849","580668","579604","12","44","196","17606","941","18547"
"2020-05-12","GA","34635","227544","0","6130","1461","262179","262179","13","20","115","10183","708","10891"
"2020-05-12","GU","152","3939","0","0","5","4091","4091","66","0","0","101","1","102"
"2020-05-12","HI","634","37305","0","81","17","37939","37939","15","0","0","254","2","256"
"2020-05-12","IA","12912","68376","0","0","289","81288","81288","19","18","0","2957","539","3496"
"2020-05-12","ID","2260","30445","0","210","70","32705","32705","16","3","3","533","30","563"
"2020-05-12","IL","83021","388670","0","0","3601","471691","471691","17","142","0","25252","4014","29266"
"2020-05-12","IN","25127","125383","0","4389","1578","150510","150510","18","38","0","3322","500","3822"
"2020-05-12","KS","7116","46993","0","660","158","54109","54109","20","0","0","0","0","0"
"2020-05-12","KY","6677","97347","0","1767","311","104024","104024","21","7","10","16864","237","17101"
"2020-05-12","LA","32050","195962","0","0","2347","228012","228012","22","39","0","6947","235","7182"
"2020-05-12","MA","79332","322164","0","7842","5141","401496","401496","25","33","110","5898","870","6768"
"2020-05-12","MD","34061","135442","0","6287","1756","169503","169503","24","73","104","4035","688","4723"
"2020-05-12","ME","1477","22092","0","202","65","23569","23569","23","0","2","0","15","15"
"2020-05-12","MI","48021","259869","0","0","4674","307890","307890","26","90","0","8473","469","8942"
"2020-05-12","MN","12494","108340","0","1799","614","120834","120834","27","23","83","4358","695","5053"
"2020-05-12","MO","10006","111290","0","0","524","121296","121296","29","36","0","5588","88","5676"
"2020-05-12","MP","19","2854","0","0","2","2873","2873","69","0","0","178","0","178"
"2020-05-12","MS","9908","87784","0","1582","457","97692","97692","28","22","36","1573","234","1807"
"2020-05-12","MT","461","22574","0","63","16","23035","23035","30","0","1","461","2","463"
"2020-05-12","NC","15346","186898","0","0","577","202244","202244","37","27","0","6078","301","6379"
"2020-05-12","ND","1571","46261","0","122","38","47832","47832","38","2","7","765","53","818"
"2020-05-12","NE","8572","39371","0","0","100","47943","47943","31","2","0","1447","257","1704"
"2020-05-12","NH","3160","32401","54","318","133","35615","35561","33","0","0","678","0","678"
"2020-05-12","NJ","140743","292317","0","0","9508","433060","433060","34","198","0","6329","798","7127"
"2020-05-12","NM","5069","101652","0","886","208","106721","106721","35","8","97","4017","206","4223"
"2020-05-12","NV","6311","57764","0","0","312","64075","64075","32","6","0","3832","159","3991"
"2020-05-12","NY","338485","886628","0","73143","21845","1225113","1225113","36","205","0","19032","1430","20462"
"2020-05-12","OH","25250","192481","0","4539","1436","217731","217731","39","79","126","6728","473","7201"
"2020-05-12","OK","4732","91379","0","828","278","96111","96111","40","4","0","0","119","119"
"2020-05-12","OR","3286","74320","0","673","130","77606","77606","41","0","0","0","0","0"
"2020-05-12","PA","57991","237989","0","0","3806","295980","295980","42","75","0","6285","837","7122"
"2020-05-12","PR","2299","0","0","0","114","2299","2299","72","1","0","0","43","43"
"2020-05-12","RI","11614","83625","0","1307","444","95239","95239","44","14","27","1743","164","1907"
"2020-05-12","SC","7927","85213","0","1338","355","93140","93140","45","24","86","8409","274","8683"
"2020-05-12","SD","3663","21534","0","271","39","25197","25197","46","5","8","570","49","619"
"2020-05-12","TN","16111","267713","0","1363","265","283824","283824","47","14","19","9980","567","10547"
"2020-05-12","TX","41048","497124","0","0","1133","538172","538172","48","33","0","11296","1179","12475"
"2020-05-12","UT","6432","147053","0","535","73","153485","153485","49","5","18","2830","70","2900"
"2020-05-12","VA","25800","129529","447","4929","891","155776","155329","51","41","152","3982","730","4712"
"2020-05-12","VI","69","1115","58","0","6","1242","1184","78","1","0","5","0","5"
"2020-05-12","VT","927","20335","0","0","53","21262","21262","50","0","0","390","1","391"
"2020-05-12","WA","17122","234986","0","0","945","252108","252108","53","14","0","3002","231","3233"
"2020-05-12","WI","10611","112748","180","1877","418","123539","123359","55","9","31","4715","193","4908"
"2020-05-12","WV","1371","63698","0","0","57","65069","65069","54","3","0","1595","5","1600"
"2020-05-12","WY","675","14384","0","67","7","15059","15059","56","0","1","2981","13","2994"
"2020-05-11","AK","381","28299","0","0","10","28680","28680","02","0","0","1314","2","1316"
"2020-05-11","AL","10009","119435","0","1256","401","129444","129444","01","8","16","1791","232","2023"
"2020-05-11","AR","4034","64996","0","480","94","69030","69030","05","6","9","3215","287","3502"
"2020-05-11","AS","0","105","0","0","0","105","105","60","0","0","22","0","22"
"2020-05-11","AZ","11380","105084","0","1537","542","116464","116464","04","6","9","5826","261","6087"
"2020-05-11","CA","67939","923958","0","0","2770","991897","991897","06","25","0","34974","1259","36233"
"2020-05-11","CO","19899","88891","0","3689","981","108790","108790","08","14","66","7656","524","8180"
"2020-05-11","CT","33765","98743","0","9389","3008","132508","132508","09","41","0","2105","211","2316"
"2020-05-11","DC","6389","23872","0","0","328","30261","30261","11","5","0","574","117","691"
"2020-05-11","DE","6565","25363","0","0","225","31928","31928","10","1","0","771","118","889"
"2020-05-11","FL","40982","520075","1080","7458","1805","562137","561057","12","14","54","21723","386","22109"
"2020-05-11","GA","33927","217361","0","6015","1441","251288","251288","13","36","18","7255","486","7741"
"2020-05-11","GU","151","3838","0","0","5","3989","3989","66","0","0","195","0","195"
"2020-05-11","HI","632","37051","0","81","17","37683","37683","15","0","0","412","1","413"
"2020-05-11","IA","12373","65419","0","0","271","77792","77792","19","6","0","3204","414","3618"
"2020-05-11","ID","2230","29912","0","207","67","32142","32142","16","0","0","0","0","0"
"2020-05-11","IL","79007","363418","0","0","3459","442425","442425","17","53","0","11175","1266","12441"
"2020-05-11","IN","24627","122061","0","4389","1540","146688","146688","18","32","0","6158","501","6659"
"2020-05-11","KS","7116","46993","0","660","158","54109","54109","20","1","3","1436","168","1604"
"2020-05-11","KY","6440","80483","0","1757","304","86923","86923","21","0","0","0","0","0"
"2020-05-11","LA","31815","189015","0","0","2308","220830","220830","22","22","0","4743","215","4958"
"2020-05-11","MA","78462","316266","0","7732","5108","394728","394728","25","129","115","5670","669","6339"
"2020-05-11","MD","33373","131407","0","6183","1683","164780","164780","24","39","228","4063","786","4849"
"2020-05-11","ME","1462","22092","0","200","65","23554","23554","23","1","1","0","26","26"
"2020-05-11","MI","47552","251396","0","0","4584","298948","298948","26","33","0","12856","414","13270"
"2020-05-11","MN","11799","103982","0","1716","591","115781","115781","27","13","59","4165","528","4693"
"2020-05-11","MO","9918","105702","0","0","488","115620","115620","29","6","0","0","74","74"
"2020-05-11","MP","19","2676","0","0","2","2695","2695","69","0","0","355","3","358"
"2020-05-11","MS","9674","86211","0","1546","435","95885","95885","28","5","15","14110","173","14283"
"2020-05-11","MT","459","22113","0","62","16","22572","22572","30","0","0","867","1","868"
"2020-05-11","NC","15045","180820","0","0","550","195865","195865","37","3","0","3449","281","3730"
"2020-05-11","ND","1518","45496","0","115","36","47014","47014","38","1","5","2118","27","2145"
"2020-05-11","NE","8315","37924","0","0","98","46239","46239","31","2","0","589","81","670"
"2020-05-11","NH","3160","31723","261","318","133","35144","34883","33","2","5","1281","149","1430"
"2020-05-11","NJ","139945","285988","0","0","9310","425933","425933","34","55","0","112073","1413","113486"
"2020-05-11","NM","4863","97635","0","789","200","102498","102498","35","9","0","5360","85","5445"
"2020-05-11","NV","6152","53932","0","0","306","60084","60084","32","0","0","1221","54","1275"
"2020-05-11","NY","337055","867596","0","73143","21640","1204651","1204651","36","162","428","19993","1660","21653"
"2020-05-11","OH","24777","185753","0","4413","1357","210530","210530","39","16","62","4972","696","5668"
"2020-05-11","OK","4613","91379","0","828","274","95992","95992","40","2","2","0","24","24"
"2020-05-11","OR","3286","74320","0","673","130","77606","77606","41","3","3","2041","58","2099"
"2020-05-11","PA","57154","231704","0","0","3731","288858","288858","42","24","0","3932","543","4475"
"2020-05-11","PR","2256","0","0","0","113","2256","2256","72","2","0","0","58","58"
"2020-05-11","RI","11450","81882","0","1280","430","93332","93332","44","8","29","1943","176","2119"
"2020-05-11","SC","7653","76804","0","1252","331","84457","84457","45","0","0","0","0","0"
"2020-05-11","SD","3614","20964","0","263","34","24578","24578","46","0","2","587","97","684"
"2020-05-11","TN","15544","257733","0","1344","251","273277","273277","47","8","19","10849","559","11408"
"2020-05-11","TX","39869","485828","0","0","1100","525697","525697","48","12","0","22921","1000","23921"
"2020-05-11","UT","6362","144223","0","517","68","150585","150585","49","1","5","3964","111","4075"
"2020-05-11","VA","25070","125547","432","4777","850","151049","150617","51","11","21","6573","989","7562"
"2020-05-11","VI","69","1110","36","0","5","1215","1179","78","1","0","8","0","8"
"2020-05-11","VT","926","19945","0","0","53","20871","20871","50","0","0","824","-1","823"
"2020-05-11","WA","16891","231984","0","0","931","248875","248875","53","10","0","5669","217","5886"
"2020-05-11","WI","10418","108033","180","1846","409","118631","118451","55","9","26","2870","199","3069"
"2020-05-11","WV","1366","62103","0","0","54","63469","63469","54","0","0","819","6","825"
"2020-05-11","WY","662","11403","0","66","7","12065","12065","56","0","1","0","1","1"
"2020-05-10","AK","379","26985","0","0","10","27364","27364","02","0","0","914","1","915"
"2020-05-10","AL","9777","117644","0","1240","393","127421","127421","01","5","12","1717","210","1927"
"2020-05-10","AR","3747","61781","0","471","88","65528","65528","05","0","0","0","0","0"
"2020-05-10","AS","0","83","0","0","0","83","83","60","0","0","0","0","0"
"2020-05-10","AZ","11119","99258","0","1528","536","110377","110377","04","4","14","4408","159","4567"
"2020-05-10","CA","66680","888984","0","0","2745","955664","955664","06","67","0","40975","2119","43094"
"2020-05-10","CO","19375","81235","0","3623","967","100610","100610","08","7","23","3290","548","3838"
"2020-05-10","CT","33554","96638","0","9389","2967","130192","130192","09","35","0","6053","570","6623"
"2020-05-10","DC","6272","23298","0","0","323","29570","29570","11","12","0","1217","170","1387"
"2020-05-10","DE","6447","24592","0","0","224","31039","31039","10","3","0","1573","170","1743"
"2020-05-10","FL","40596","498352","1265","7404","1791","540213","538948","12","6","79","10622","595","11217"
"2020-05-10","GA","33441","210106","0","5997","1405","243547","243547","13","5","10","7314","909","8223"
"2020-05-10","GU","151","3643","0","0","5","3794","3794","66","0","0","0","0","0"
"2020-05-10","HI","631","36639","0","81","17","37270","37270","15","0","0","1006","2","1008"
"2020-05-10","IA","11959","62215","0","0","265","74174","74174","19","13","0","2410","288","2698"
"2020-05-10","ID","2230","29912","0","207","67","32142","32142","16","0","1","311","25","336"
"2020-05-10","IL","77741","352243","0","0","3406","429984","429984","17","57","0","11997","1656","13653"
"2020-05-10","IN","24126","115903","0","4389","1508","140029","140029","18","18","0","3949","394","4343"
"2020-05-10","KS","6948","45557","0","657","157","52505","52505","20","0","22","2375","197","2572"
"2020-05-10","KY","6440","80483","0","1757","304","86923","86923","21","6","61","324","152","476"
"2020-05-10","LA","31600","184272","0","0","2286","215872","215872","22","19","0","3532","183","3715"
"2020-05-10","MA","77793","310596","0","7617","4979","388389","388389","25","139","66","10802","1050","11852"
"2020-05-10","MD","32587","127344","0","5955","1644","159931","159931","24","30","23","2850","1053","3903"
"2020-05-10","ME","1436","22092","0","199","64","23528","23528","23","0","1","0","28","28"
"2020-05-10","MI","47138","238540","0","0","4551","285678","285678","26","25","0","11810","382","12192"
"2020-05-10","MN","11271","99817","0","1657","578","111088","111088","27","20","45","4344","481","4825"
"2020-05-10","MO","9844","105702","0","0","482","115546","115546","29","10","0","6470","178","6648"
"2020-05-10","MP","16","2321","0","0","2","2337","2337","69","0","0","0","0","0"
"2020-05-10","MS","9501","72101","0","1531","430","81602","81602","28","9","19","0","123","123"
"2020-05-10","MT","458","21246","0","62","16","21704","21704","30","0","0","375","0","375"
"2020-05-10","NC","14764","177371","0","0","547","192135","192135","37","3","0","5369","404","5773"
"2020-05-10","ND","1491","43378","0","110","35","44869","44869","38","0","0","909","27","936"
"2020-05-10","NE","8234","37335","0","0","96","45569","45569","31","4","0","2190","403","2593"
"2020-05-10","NH","3011","30442","512","313","131","33965","33453","33","10","4","1091","64","1155"
"2020-05-10","NJ","138532","173915","591","0","9255","313038","312447","34","139","0","5794","1447","7241"
"2020-05-10","NM","4778","92275","0","789","191","97053","97053","35","10","0","3686","105","3791"
"2020-05-10","NV","6098","52711","0","0","306","58809","58809","32","5","0","2628","70","2698"
"2020-05-10","NY","335395","847603","0","72715","21478","1182998","1182998","36","207","460","26957","2273","29230"
"2020-05-10","OH","24081","180781","0","4351","1341","204862","204862","39","10","51","7808","384","8192"
"2020-05-10","OK","4589","91379","0","826","272","95968","95968","40","2","4","0","99","99"
"2020-05-10","OR","3228","72279","0","670","127","75507","75507","41","0","8","819","68","887"
"2020-05-10","PA","56611","227772","0","0","3707","284383","284383","42","19","0","5981","1295","7276"
"2020-05-10","PR","2198","0","0","0","111","2198","2198","72","3","0","0","25","25"
"2020-05-10","RI","11274","79939","0","1251","422","91213","91213","44","4","33","3113","285","3398"
"2020-05-10","SC","7653","76804","0","1252","331","84457","84457","45","1","0","3372","122","3494"
"2020-05-10","SD","3517","20377","0","261","34","23894","23894","46","0","8","818","124","942"
"2020-05-10","TN","14985","246884","0","1325","243","261869","261869","47","1","6","8904","217","9121"
"2020-05-10","TX","38869","462907","0","0","1088","501776","501776","48","39","0","11473","1009","12482"
"2020-05-10","UT","6251","140259","0","512","67","146510","146510","49","1","14","3068","148","3216"
"2020-05-10","VA","24081","118974","506","4756","839","143561","143055","51","12","39","5021","885","5906"
"2020-05-10","VI","69","1102","39","0","4","1210","1171","78","0","0","78","1","79"
"2020-05-10","VT","927","19121","0","0","53","20048","20048","50","0","0","515","6","521"
"2020-05-10","WA","16674","226315","0","0","921","242989","242989","53","16","0","6868","286","7154"
"2020-05-10","WI","10219","105163","182","1820","400","115564","115382","55","2","14","3228","280","3508"
"2020-05-10","WV","1360","61284","0","0","54","62644","62644","54","1","0","1622","25","1647"
"2020-05-10","WY","661","11403","0","65","7","12064","12064","56","0","1","0","17","17"
"2020-05-09","AK","378","26071","0","0","10","26449","26449","02","0","0","975","1","976"
"2020-05-09","AL","9567","115927","0","1228","388","125494","125494","01","13","21","5034","346","5380"
"2020-05-09","AR","3747","61781","0","471","88","65528","65528","05","0","5","1481","53","1534"
"2020-05-09","AS","0","83","0","0","0","83","83","60","0","0","0","0","0"
"2020-05-09","AZ","10960","94850","0","1514","532","105810","105810","04","15","32","4251","434","4685"
"2020-05-09","CA","64561","848009","0","0","2678","912570","912570","06","93","0","35249","2049","37298"
"2020-05-09","CO","18827","77945","0","3600","960","96772","96772","08","-1","43","2210","26","2236"
"2020-05-09","CT","32984","90585","0","9389","2932","123569","123569","09","58","0","2455","573","3028"
"2020-05-09","DC","6102","22081","0","0","311","28183","28183","11","7","0","865","203","1068"
"2020-05-09","DE","6277","23019","0","0","221","29296","29296","10","8","0","866","166","1032"
"2020-05-09","FL","40001","487730","1452","7325","1785","529183","527731","12","47","168","13588","802","14390"
"2020-05-09","GA","32532","202792","0","5987","1400","235324","235324","13","23","52","7331","426","7757"
"2020-05-09","GU","151","3643","0","0","5","3794","3794","66","0","0","17","0","17"
"2020-05-09","HI","629","35633","0","81","17","36262","36262","15","0","7","-356","0","-356"
"2020-05-09","IA","11671","59805","0","0","252","71476","71476","19","9","0","1001","214","1215"
"2020-05-09","ID","2205","29601","0","206","67","31806","31806","16","0","0","509","27","536"
"2020-05-09","IL","76085","340246","0","0","3349","416331","416331","17","108","0","14292","2325","16617"
"2020-05-09","IN","23732","111954","0","4389","1490","135686","135686","18","43","0","4972","586","5558"
"2020-05-09","KS","6751","43182","0","635","157","49933","49933","20","5","27","1975","250","2225"
"2020-05-09","KY","6288","80159","0","1696","298","86447","86447","21","4","12","4887","159","5046"
"2020-05-09","LA","31417","180740","0","0","2267","212157","212157","22","40","0","9179","562","9741"
"2020-05-09","MA","76743","299794","0","7551","4840","376537","376537","25","138","117","9104","1410","10514"
"2020-05-09","MD","31534","124494","0","5932","1614","156028","156028","24","54","121","2792","1049","3841"
"2020-05-09","ME","1408","22092","0","198","64","23500","23500","23","1","4","0","34","34"
"2020-05-09","MI","46756","226730","0","0","4526","273486","273486","26","133","0","12803","430","13233"
"2020-05-09","MN","10790","95473","0","1612","558","106263","106263","27","24","63","4291","702","4993"
"2020-05-09","MO","9666","99232","0","0","472","108898","108898","29","23","0","0","177","177"
"2020-05-09","MP","16","2321","0","0","2","2337","2337","69","0","0","0","1","1"
"2020-05-09","MS","9378","72101","0","1512","421","81479","81479","28","12","34","0","288","288"
"2020-05-09","MT","458","20871","0","62","16","21329","21329","30","0","0","384","0","384"
"2020-05-09","NC","14360","172002","0","0","544","186362","186362","37","17","0","7257","492","7749"
"2020-05-09","ND","1464","42469","0","110","35","43933","43933","38","2","6","1393","39","1432"
"2020-05-09","NE","7831","35145","0","0","92","42976","42976","31","2","0","1923","641","2564"
"2020-05-09","NH","2947","29351","304","309","121","32602","32298","33","7","1","1522","104","1626"
"2020-05-09","NJ","137085","168121","557","0","9116","305763","305206","34","164","0","4816","1631","6447"
"2020-05-09","NM","4673","88589","0","789","181","93262","93262","35","9","29","4050","180","4230"
"2020-05-09","NV","6028","50083","0","0","301","56111","56111","32","8","0","2623","144","2767"
"2020-05-09","NY","333122","820646","0","72255","21271","1153768","1153768","36","226","576","29510","2715","32225"
"2020-05-09","OH","23697","172973","0","4300","1331","196670","196670","39","25","82","11673","681","12354"
"2020-05-09","OK","4490","91379","0","822","270","95869","95869","40","4","17","5946","66","6012"
"2020-05-09","OR","3160","71460","0","662","127","74620","74620","41","3","3","1835","92","1927"
"2020-05-09","PA","55316","221791","0","0","3688","277107","277107","42","72","0","5470","1078","6548"
"2020-05-09","PR","2173","0","0","0","108","2173","2173","72","1","0","0","17","17"
"2020-05-09","RI","10989","76826","0","1218","418","87815","87815","44","19","31","2339","210","2549"
"2020-05-09","SC","7531","73432","0","1252","330","80963","80963","45","14","100","7132","389","7521"
"2020-05-09","SD","3393","19559","0","253","34","22952","22952","46","3","6","1410","249","1659"
"2020-05-09","TN","14768","237980","0","1319","242","252748","252748","47","1","20","8843","327","9170"
"2020-05-09","TX","37860","451434","0","0","1049","489294","489294","48","45","0","10925","1251","12176"
"2020-05-09","UT","6103","137191","0","498","66","143294","143294","49","5","10","4422","184","4606"
"2020-05-09","VA","23196","113953","501","4717","827","137650","137149","51","15","95","6350","854","7204"
"2020-05-09","VI","68","1024","36","0","4","1128","1092","78","0","0","0","0","0"
"2020-05-09","VT","921","18606","0","0","53","19527","19527","50","0","0","517","2","519"
"2020-05-09","WA","16388","219447","0","0","905","235835","235835","53","14","0","4998","157","5155"
"2020-05-09","WI","9939","101935","204","1806","398","112078","111874","55","14","39","4670","349","5019"
"2020-05-09","WV","1335","59662","0","0","53","60997","60997","54","2","0","1536","25","1561"
"2020-05-09","WY","644","11403","0","64","7","12047","12047","56","0","4","0","9","9"
"2020-05-08","AK","377","25096","0","0","10","25473","25473","02","0","0","1129","3","1132"
"2020-05-08","AL","9221","110893","0","1207","375","120114","120114","01","26","29","4618","323","4941"
"2020-05-08","AR","3694","60300","0","466","88","63994","63994","05","1","4","3916","83","3999"
"2020-05-08","AS","0","83","0","0","0","83","83","60","0","0","0","0","0"
"2020-05-08","AZ","10526","90599","0","1482","517","101125","101125","04","67","33","4110","581","4691"
"2020-05-08","CA","62512","812760","0","0","2585","875272","875272","06","81","0","30500","1898","32398"
"2020-05-08","CO","18801","75735","0","3557","961","94536","94536","08","40","571","2218","971","3189"
"2020-05-08","CT","32411","88130","0","9389","2874","120541","120541","09","77","0","3740","627","4367"
"2020-05-08","DC","5899","21216","0","0","304","27115","27115","11","19","0","1014","245","1259"
"2020-05-08","DE","6111","22153","0","0","213","28264","28264","10","11","0","766","172","938"
"2020-05-08","FL","39199","474142","1433","7157","1738","514774","513341","12","71","167","20020","371","20391"
"2020-05-08","GA","32106","195461","0","5935","1377","227567","227567","13","41","100","9597","667","10264"
"2020-05-08","GU","151","3626","0","0","5","3777","3777","66","0","0","62","0","62"
"2020-05-08","HI","629","35989","0","74","17","36618","36618","15","0","0","1074","3","1077"
"2020-05-08","IA","11457","58804","0","0","243","70261","70261","19","12","0","3436","398","3834"
"2020-05-08","ID","2178","29092","0","206","67","31270","31270","16","1","1","360","20","380"
"2020-05-08","IL","73760","325954","0","0","3241","399714","399714","17","130","0","17784","2887","20671"
"2020-05-08","IN","23146","106982","0","4389","1447","130128","130128","18","33","4389","4703","643","5346"
"2020-05-08","KS","6501","41207","0","608","152","47708","47708","20","5","21","2529","357","2886"
"2020-05-08","KY","6129","75272","0","1684","294","81401","81401","21","11","68","2600","195","2795"
"2020-05-08","LA","30855","171561","0","0","2227","202416","202416","22","19","0","1446","203","1649"
"2020-05-08","MA","75333","290690","0","7434","4702","366023","366023","25","150","197","12779","1612","14391"
"2020-05-08","MD","30485","121702","0","5811","1560","152187","152187","24","57","148","2476","1111","3587"
"2020-05-08","ME","1374","22092","0","194","63","23466","23466","23","1","2","0","44","44"
"2020-05-08","MI","46326","213927","0","0","4393","260253","260253","26","50","0","12511","680","13191"
"2020-05-08","MN","10088","91182","0","1549","534","101270","101270","27","26","90","3126","723","3849"
"2020-05-08","MO","9489","99232","0","0","449","108721","108721","29","31","0","4951","148","5099"
"2020-05-08","MP","15","2321","0","0","2","2336","2336","69","0","0","538","0","538"
"2020-05-08","MS","9090","72101","0","1478","409","81191","81191","28","13","36","0","404","404"
"2020-05-08","MT","458","20487","0","62","16","20945","20945","30","0","0","696","2","698"
"2020-05-08","NC","13868","164745","0","0","527","178613","178613","37","20","0","6814","471","7285"
"2020-05-08","ND","1425","41076","0","104","33","42501","42501","38","2","2","1580","54","1634"
"2020-05-08","NE","7190","33222","0","0","90","40412","40412","31","4","0","2235","419","2654"
"2020-05-08","NH","2843","27829","532","308","114","31204","30672","33","3","1","1763","103","1866"
"2020-05-08","NJ","135454","163305","553","0","8952","299312","298759","34","151","0","4282","1819","6101"
"2020-05-08","NM","4493","84539","0","760","172","89032","89032","35","3","73","3146","202","3348"
"2020-05-08","NV","5884","47460","0","0","293","53344","53344","32","7","0","1869","118","1987"
"2020-05-08","NY","330407","791136","0","71679","21045","1121543","1121543","36","217","527","28869","2758","31627"
"2020-05-08","OH","23016","161300","0","4218","1306","184316","184316","39","35","78","7372","885","8257"
"2020-05-08","OK","4424","85433","0","805","266","89857","89857","40","6","0","2876","94","2970"
"2020-05-08","OR","3068","69625","0","659","124","72693","72693","41","3","14","2156","79","2235"
"2020-05-08","PA","54238","216321","0","0","3616","270559","270559","42","200","0","6448","1323","7771"
"2020-05-08","PR","2156","0","0","0","107","2156","2156","72","5","0","0","125","125"
"2020-05-08","RI","10779","74487","0","1187","399","85266","85266","44","11","34","2699","249","2948"
"2020-05-08","SC","7142","66300","0","1152","316","73442","73442","45","11","0","-4246","206","-4040"
"2020-05-08","SD","3144","18149","0","247","31","21293","21293","46","0","11","940","239","1179"
"2020-05-08","TN","14441","229137","0","1299","241","243578","243578","47","4","33","6905","345","7250"
"2020-05-08","TX","36609","440509","0","0","1004","477118","477118","48","31","0","20737","1219","21956"
"2020-05-08","UT","5919","132769","0","488","61","138688","138688","49","0","12","3950","195","4145"
"2020-05-08","VA","22342","107603","549","4622","812","130494","129945","51","43","184","6021","772","6793"
"2020-05-08","VI","68","1024","36","0","4","1128","1092","78","0","0","34","2","36"
"2020-05-08","VT","919","18089","0","0","53","19008","19008","50","0","0","554","3","557"
"2020-05-08","WA","16231","214449","0","0","891","230680","230680","53","21","0","5541","326","5867"
"2020-05-08","WI","9590","97265","204","1767","384","107059","106855","55","10","35","4230","375","4605"
"2020-05-08","WV","1310","58126","0","0","51","59436","59436","54","0","0","1892","23","1915"
"2020-05-08","WY","635","11403","0","60","7","12038","12038","56","0","1","0","4","4"
"2020-05-07","AK","374","23967","0","0","10","24341","24341","02","0","0","684","2","686"
"2020-05-07","AL","8898","106275","0","1178","349","115173","115173","01","9","20","5340","317","5657"
"2020-05-07","AR","3611","56384","0","462","87","59995","59995","05","2","9","949","43","992"
"2020-05-07","AS","0","83","0","0","0","83","83","60","0","0","0","0","0"
"2020-05-07","AZ","9945","86489","0","1449","450","96434","96434","04","24","19","4459","238","4697"
"2020-05-07","CA","60614","782260","0","0","2504","842874","842874","06","92","0","32039","1799","33838"
"2020-05-07","CO","17830","73517","0","2986","921","91347","91347","08","18","67","4905","466","5371"
"2020-05-07","CT","31784","84390","0","9389","2797","116174","116174","09","79","1631","3938","789","4727"
"2020-05-07","DC","5654","20202","0","0","285","25856","25856","11","8","0","679","193","872"
"2020-05-07","DE","5939","21387","0","0","202","27326","27326","10","9","0","697","161","858"
"2020-05-07","FL","38828","454122","1499","6990","1667","494449","492950","12","62","214","12073","826","12899"
"2020-05-07","GA","31439","185864","0","5835","1336","217303","217303","13","25","70","12423","743","13166"
"2020-05-07","GU","151","3564","0","0","5","3715","3715","66","0","0","88","0","88"
"2020-05-07","HI","626","34915","0","74","17","35541","35541","15","0","1","341","1","342"
"2020-05-07","IA","11059","55368","0","0","231","66427","66427","19","12","0","2601","655","3256"
"2020-05-07","ID","2158","28732","0","205","66","30890","30890","16","1","2","314","31","345"
"2020-05-07","IL","70873","308170","0","0","3111","379043","379043","17","137","0","15142","2641","17783"
"2020-05-07","IN","22503","102279","0","0","1414","124782","124782","18","37","0","3653","633","4286"
"2020-05-07","KS","6144","38678","0","587","147","44822","44822","20","3","16","2298","410","2708"
"2020-05-07","KY","5934","72672","0","1616","283","78606","78606","21","8","13","17480","112","17592"
"2020-05-07","LA","30652","170115","0","0","2208","200767","200767","22","93","0","5842","253","6095"
"2020-05-07","MA","73721","277911","0","7237","4552","351632","351632","25","132","157","10297","1696","11993"
"2020-05-07","MD","29374","119226","0","5663","1503","148600","148600","24","66","166","3377","1211","4588"
"2020-05-07","ME","1330","22092","0","192","62","23422","23422","23","0","1","0","76","76"
"2020-05-07","MI","45646","201416","0","0","4343","247062","247062","26","93","0","13239","592","13831"
"2020-05-07","MN","9365","88056","0","1459","508","97421","97421","27","23","54","3403","786","4189"
"2020-05-07","MO","9341","94281","0","0","418","103622","103622","29","22","0","2636","239","2875"
"2020-05-07","MP","15","1783","0","0","2","1798","1798","69","0","0","0","0","0"
"2020-05-07","MS","8686","72101","0","1442","396","80787","80787","28","22","50","0","262","262"
"2020-05-07","MT","456","19791","0","62","16","20247","20247","30","0","0","543","0","543"
"2020-05-07","NC","13397","157931","0","0","507","171328","171328","37","30","0","6207","639","6846"
"2020-05-07","ND","1371","39496","0","102","31","40867","40867","38","0","5","2187","48","2235"
"2020-05-07","NE","6771","30987","0","0","86","37758","37758","31","4","0","1297","333","1630"
"2020-05-07","NH","2740","26066","345","307","111","29151","28806","33","19","12","969","104","1073"
"2020-05-07","NJ","133635","159023","552","0","8801","293210","292658","34","252","0","1993","1745","3738"
"2020-05-07","NM","4291","81393","0","687","169","85684","85684","35","7","0","2280","153","2433"
"2020-05-07","NV","5766","45591","0","0","286","51357","51357","32","10","0","1979","103","2082"
"2020-05-07","NY","327649","762267","0","71152","20828","1089916","1089916","36","951","613","30324","3671","33995"
"2020-05-07","OH","22131","153928","0","4140","1271","176059","176059","39","46","88","6575","555","7130"
"2020-05-07","OK","4330","82557","0","805","260","86887","86887","40","7","32","3868","129","3997"
"2020-05-07","OR","2989","67469","0","645","121","70458","70458","41","6","4","2409","73","2482"
"2020-05-07","PA","52915","209873","0","0","3416","262788","262788","42","310","0","5378","1070","6448"
"2020-05-07","PR","2031","0","0","0","102","2031","2031","72","3","0","0","63","63"
"2020-05-07","RI","10530","71788","0","1153","388","82318","82318","44","18","30","2620","325","2945"
"2020-05-07","SC","6936","70546","0","1152","305","77482","77482","45","0","0","0","0","0"
"2020-05-07","SD","2905","17209","0","236","31","20114","20114","46","2","6","572","126","698"
"2020-05-07","TN","14096","222232","0","1266","237","236328","236328","47","-2","45","9069","158","9227"
"2020-05-07","TX","35390","419772","0","0","973","455162","455162","48","25","0","15256","968","16224"
"2020-05-07","UT","5724","128819","0","476","61","134543","134543","49","3","12","3412","129","3541"
"2020-05-07","VA","21570","101582","519","4438","769","123671","123152","51","56","325","8130","1314","9444"
"2020-05-07","VI","66","990","37","0","4","1093","1056","78","0","0","0","0","0"
"2020-05-07","VT","916","17535","0","0","53","18451","18451","50","1","0","567","8","575"
"2020-05-07","WA","15905","208908","0","0","870","224813","224813","53","8","0","5049","311","5360"
"2020-05-07","WI","9215","93035","219","1732","374","102469","102250","55","12","38","5209","314","5523"
"2020-05-07","WV","1287","56234","0","0","51","57521","57521","54","1","0","1698","39","1737"
"2020-05-07","WY","631","11403","0","59","7","12034","12034","56","0","-1","0","27","27"
"2020-05-06","AK","372","23283","0","0","10","23655","23655","02","1","0","962","1","963"
"2020-05-06","AL","8581","100935","0","1158","340","109516","109516","01","27","51","2454","296","2750"
"2020-05-06","AR","3568","55435","0","453","85","59003","59003","05","5","0","4296","72","4368"
"2020-05-06","AS","0","83","0","0","0","83","83","60","0","0","0","0","0"
"2020-05-06","AZ","9707","82030","0","1430","426","91737","91737","04","31","33","3075","402","3477"
"2020-05-06","CA","58815","750221","0","0","2412","809036","809036","06","95","0","26531","2603","29134"
"2020-05-06","CO","17364","68612","0","2919","903","85976","85976","08","52","81","515","457","972"
"2020-05-06","CT","30995","80452","0","7758","2718","111447","111447","09","85","0","2430","374","2804"
"2020-05-06","DC","5461","19523","0","0","277","24984","24984","11","13","0","516","139","655"
"2020-05-06","DE","5778","20690","0","0","193","26468","26468","10","6","0","1381","407","1788"
"2020-05-06","FL","38002","442049","1351","6776","1605","481402","480051","12","69","230","13797","563","14360"
"2020-05-06","GA","30696","173441","0","5765","1311","204137","204137","13","23","131","2269","985","3254"
"2020-05-06","GU","151","3476","0","0","5","3627","3627","66","0","0","135","2","137"
"2020-05-06","HI","625","34574","0","73","17","35199","35199","15","0","0","1196","4","1200"
"2020-05-06","IA","10404","52767","0","0","219","63171","63171","19","12","0","2309","293","2602"
"2020-05-06","ID","2127","28418","0","203","65","30545","30545","16","1","2","216","21","237"
"2020-05-06","IL","68232","293028","0","0","2974","361260","361260","17","136","0","12704","2270","14974"
"2020-05-06","IN","21870","98626","0","0","1377","120496","120496","18","51","0","3825","837","4662"
"2020-05-06","KS","5734","36380","0","571","144","42114","42114","20","7","5","1746","276","2022"
"2020-05-06","KY","5822","55192","0","1603","275","61014","61014","21","14","74","390","577","967"
"2020-05-06","LA","30399","164273","0","0","2115","194672","194672","22","0","0","6038","403","6441"
"2020-05-06","MA","72025","267614","0","7080","4420","339639","339639","25","208","249","4536","1754","6290"
"2020-05-06","MD","28163","115849","0","5497","1437","144012","144012","24","47","160","2863","1046","3909"
"2020-05-06","ME","1254","22092","0","191","62","23346","23346","23","1","4","2546","28","2574"
"2020-05-06","MI","45054","188177","0","0","4250","233231","233231","26","71","0","9738","657","10395"
"2020-05-06","MN","8579","84653","0","1405","485","93232","93232","27","30","55","4495","728","5223"
"2020-05-06","MO","9102","91645","0","0","396","100747","100747","29","19","0","5495","186","5681"
"2020-05-06","MP","15","1783","0","0","2","1798","1798","69","0","0","0","1","1"
"2020-05-06","MS","8424","72101","0","1392","374","80525","80525","28","32","40","0","217","217"
"2020-05-06","MT","456","19248","0","62","16","19704","19704","30","0","0","4432","0","4432"
"2020-05-06","NC","12758","151724","0","0","477","164482","164482","37","25","0","12180","502","12682"
"2020-05-06","ND","1323","37309","0","97","31","38632","38632","38","6","2","2154","57","2211"
"2020-05-06","NE","6438","29690","0","0","82","36128","36128","31","4","0","1164","355","1519"
"2020-05-06","NH","2636","25097","79","295","92","27812","27733","33","6","9","815","48","863"
"2020-05-06","NJ","131890","157030","594","0","8549","289514","288920","34","305","0","0","1297","1297"
"2020-05-06","NM","4138","79113","0","687","162","83251","83251","35","6","20","1424","107","1531"
"2020-05-06","NV","5663","43612","0","0","276","49275","49275","32","8","0","1322","69","1391"
"2020-05-06","NY","323978","731943","0","70539","19877","1055921","1055921","36","232","672","24236","2786","27022"
"2020-05-06","OH","21576","147353","0","4052","1225","168929","168929","39","90","96","7587","607","8194"
"2020-05-06","OK","4201","78689","0","773","253","82890","82890","40","6","0","3399","74","3473"
"2020-05-06","OR","2916","65060","0","641","115","67976","67976","41","2","19","2475","77","2552"
"2020-05-06","PA","51845","204495","0","0","3106","256340","256340","42","94","0","4570","888","5458"
"2020-05-06","PR","1968","0","0","0","99","1968","1968","72","0","0","0","44","-9269"
"2020-05-06","RI","10205","69168","0","1123","370","79373","79373","44","15","31","2666","272","2938"
"2020-05-06","SC","6936","70546","0","1152","305","77482","77482","45","22","42","9532","179","9711"
"2020-05-06","SD","2779","16637","0","230","29","19416","19416","46","5","10","336","58","394"
"2020-05-06","TN","13938","213163","0","1221","239","227101","227101","47","13","65","7991","248","8239"
"2020-05-06","TX","34422","404516","0","0","948","438938","438938","48","42","0","10675","1053","11728"
"2020-05-06","UT","5595","125407","0","464","58","131002","131002","49","2","8","4141","146","4287"
"2020-05-06","VA","20256","93452","469","4113","713","114177","113708","51","0","0","0","0","0"
"2020-05-06","VI","66","990","37","0","4","1093","1056","78","0","0","17","0","17"
"2020-05-06","VT","908","16968","0","0","52","17876","17876","50","0","0","357","1","358"
"2020-05-06","WA","15594","203859","0","0","862","219453","219453","53","21","0","3001","132","3133"
"2020-05-06","WI","8901","87826","212","1694","362","96939","96727","55","9","31","3859","335","4194"
"2020-05-06","WV","1248","54536","0","0","50","55784","55784","54","0","0","951","10","961"
"2020-05-06","WY","604","11403","0","60","7","12007","12007","56","0","0","1084","8","1092"
"2020-05-05","AK","371","22321","0","0","9","22692","22692","02","0","0","968","1","969"
"2020-05-05","AL","8285","98481","0","1107","313","106766","106766","01","17","43","3389","260","3649"
"2020-05-05","AR","3496","51139","0","453","80","54635","54635","05","-1","15","155","38","193"
"2020-05-05","AS","0","83","0","0","0","83","83","60","0","0","0","0","0"
"2020-05-05","AZ","9305","78955","0","1397","395","88260","88260","04","33","40","2621","386","3007"
"2020-05-05","CA","56212","723690","0","0","2317","779902","779902","06","63","0","30753","1275","32028"
"2020-05-05","CO","16907","68097","0","2838","851","85004","85004","08","9","39","1642","272","1914"
"2020-05-05","CT","30621","78022","0","7758","2633","108643","108643","09","138","0","4816","1334","6150"
"2020-05-05","DC","5322","19007","0","0","264","24329","24329","11","6","0","382","152","534"
"2020-05-05","DE","5371","19309","0","0","187","24680","24680","10","5","0","487","83","570"
"2020-05-05","FL","37439","428252","1265","6546","1536","466956","465691","12","113","217","20879","542","21421"
"2020-05-05","GA","29711","171172","0","5634","1288","200883","200883","13","66","108","17215","343","17558"
"2020-05-05","GU","149","3341","0","0","5","3490","3490","66","0","0","99","0","99"
"2020-05-05","HI","621","33378","0","73","17","33999","33999","15","0","0","132","1","133"
"2020-05-05","IA","10111","50458","0","0","207","60569","60569","19","19","0","3000","408","3408"
"2020-05-05","ID","2106","28202","0","201","64","30308","30308","16","0","1","456","45","501"
"2020-05-05","IL","65962","280324","0","0","2838","346286","346286","17","176","0","11017","2122","13139"
"2020-05-05","IN","21033","94801","0","0","1326","115834","115834","18","62","0","2011","526","2537"
"2020-05-05","KS","5458","34634","0","566","137","40092","40092","20","1","13","1276","213","1489"
"2020-05-05","KY","5245","54802","0","1529","261","60047","60047","21","8","10","1523","115","1638"
"2020-05-05","LA","29996","158235","0","0","2115","188231","188231","22","51","0","6977","323","7300"
"2020-05-05","MA","70271","263078","0","6831","4212","333349","333349","25","122","209","7897","1184","9081"
"2020-05-05","MD","27117","112986","0","5337","1390","140103","140103","24","73","138","2399","709","3108"
"2020-05-05","ME","1226","19546","0","187","61","20772","20772","23","4","1","0","21","21"
"2020-05-05","MI","44397","178439","0","0","4179","222836","222836","26","130","0","0","447","447"
"2020-05-05","MN","7851","80158","0","1350","455","88009","88009","27","27","79","1451","617","2068"
"2020-05-05","MO","8916","86150","0","0","377","95066","95066","29","19","0","3453","162","3615"
"2020-05-05","MP","14","1783","0","0","2","1797","1797","69","0","0","462","0","462"
"2020-05-05","MS","8207","72101","0","1352","342","80308","80308","28","32","36","301","330","631"
"2020-05-05","MT","456","14816","0","62","16","15272","15272","30","0","0","185","-1","184"
"2020-05-05","NC","12256","139544","0","0","452","151800","151800","37","22","0","4953","408","5361"
"2020-05-05","ND","1266","35155","0","95","25","36421","36421","38","0","1","1626","41","1667"
"2020-05-05","NE","6083","28526","0","0","78","34609","34609","31","0","0","682","173","855"
"2020-05-05","NH","2588","24282","79","286","86","26949","26870","33","0","0","0","0","0"
"2020-05-05","NJ","130593","157030","550","0","8244","288173","287623","34","334","0","8079","2324","10403"
"2020-05-05","NM","4031","77689","0","667","156","81720","81720","35","5","80","3562","181","3743"
"2020-05-05","NV","5594","42290","0","0","268","47884","47884","32","6","0","1615","103","1718"
"2020-05-05","NY","321192","707707","0","69867","19645","1028899","1028899","36","230","536","19350","2239","21589"
"2020-05-05","OH","20969","139766","0","3956","1135","160735","160735","39","79","147","5085","495","5580"
"2020-05-05","OK","4127","75290","0","773","247","79417","79417","40","9","20","15486","83","15569"
"2020-05-05","OR","2839","62585","0","622","113","65424","65424","41","4","14","1887","80","1967"
"2020-05-05","PA","50957","199925","0","0","3012","250882","250882","42","554","0","4427","865","5292"
"2020-05-05","PR","1924","9313","0","0","99","11237","11237","72","2","0","0","81","81"
"2020-05-05","RI","9933","66502","0","1092","355","76435","76435","44","14","31","2018","281","2299"
"2020-05-05","SC","6757","61014","0","1110","283","67771","67771","45","8","0","3452","131","3583"
"2020-05-05","SD","2721","16301","0","220","24","19022","19022","46","3","9","256","53","309"
"2020-05-05","TN","13690","205172","0","1156","226","218862","218862","47","7","13","7300","119","7419"
"2020-05-05","TX","33369","393841","0","0","906","427210","427210","48","22","0","18775","1037","19812"
"2020-05-05","UT","5449","121266","0","456","56","126715","126715","49","6","15","1922","132","2054"
"2020-05-05","VA","20256","93452","469","4113","713","114177","113708","51","29","103","651","764","1415"
"2020-05-05","VI","66","973","34","0","4","1073","1039","78","0","0","8","0","8"
"2020-05-05","VT","907","16611","0","0","52","17518","17518","50","0","0","181","5","186"
"2020-05-05","WA","15462","200858","0","0","841","216320","216320","53","7","0","4038","277","4315"
"2020-05-05","WI","8566","83967","236","1663","353","92769","92533","55","13","42","3500","330","3830"
"2020-05-05","WV","1238","53585","0","0","50","54823","54823","54","0","0","1552","32","1584"
"2020-05-05","WY","596","10319","0","60","7","10915","10915","56","0","0","451","10","461"
"2020-05-04","AK","370","21353","0","0","9","21723","21723","02","0","0","143","2","145"
"2020-05-04","AL","8025","95092","0","1064","296","103117","103117","01","6","29","10317","300","10617"
"2020-05-04","AR","3458","50984","0","438","81","54442","54442","05","5","11","1525","27","1552"
"2020-05-04","AS","0","83","0","0","0","83","83","60","0","0","26","0","26"
"2020-05-04","AZ","8919","76334","0","1357","362","85253","85253","04","0","9","3855","279","4134"
"2020-05-04","CA","54937","692937","0","0","2254","747874","747874","06","39","0","30802","1321","32123"
"2020-05-04","CO","16635","66455","0","2799","842","83090","83090","08","10","6","2774","410","3184"
"2020-05-04","CT","29287","73206","0","7758","2495","102493","102493","09","59","0","0","0","0"
"2020-05-04","DC","5170","18625","0","0","258","23795","23795","11","7","0","539","154","693"
"2020-05-04","DE","5288","18822","0","0","182","24110","24110","10","5","0","293","80","373"
"2020-05-04","FL","36897","407373","1181","6329","1423","445451","444270","12","20","85","15262","819","16081"
"2020-05-04","GA","29368","153957","0","5526","1222","183325","183325","13","45","133","7463","766","8229"
"2020-05-04","GU","149","3242","0","0","5","3391","3391","66","0","0","90","-1","89"
"2020-05-04","HI","620","33246","0","73","17","33866","33866","15","1","1","916","0","916"
"2020-05-04","IA","9703","47458","0","0","188","57161","57161","19","4","0","3441","534","3975"
"2020-05-04","ID","2061","27746","0","200","64","29807","29807","16","1","0","0","0","0"
"2020-05-04","IL","63840","269307","0","0","2662","333147","333147","17","44","0","11493","2341","13834"
"2020-05-04","IN","20507","92790","0","0","1264","113297","113297","18","18","0","3864","574","4438"
"2020-05-04","KS","5245","33358","0","553","136","38603","38603","20","2","6","1610","215","1825"
"2020-05-04","KY","5130","53279","0","1519","253","58409","58409","21","5","108","509","251","760"
"2020-05-04","LA","29673","151258","0","0","2064","180931","180931","22","95","0","4438","333","4771"
"2020-05-04","MA","69087","255181","0","6622","4090","324268","324268","25","86","115","8622","1000","9622"
"2020-05-04","MD","26408","110587","0","5199","1317","136995","136995","24","36","148","3255","946","4201"
"2020-05-04","ME","1205","19546","0","186","57","20751","20751","23","0","3","0","20","20"
"2020-05-04","MI","43950","178439","0","0","4049","222389","222389","26","0","0","9661","196","9857"
"2020-05-04","MN","7234","78707","0","1271","428","85941","85941","27","9","72","2738","571","3309"
"2020-05-04","MO","8754","82697","0","0","358","91451","91451","29","6","0","8107","368","8475"
"2020-05-04","MP","14","1321","0","0","2","1335","1335","69","0","0","0","0","0"
"2020-05-04","MS","7877","71800","0","1316","310","79677","79677","28","7","18","1757","327","2084"
"2020-05-04","MT","457","14631","0","62","16","15088","15088","30","0","1","79","2","81"
"2020-05-04","NC","11848","134591","0","0","430","146439","146439","37","8","0","2420","184","2604"
"2020-05-04","ND","1225","33529","0","94","25","34754","34754","38","0","4","1367","34","1401"
"2020-05-04","NE","5910","27844","0","0","78","33754","33754","31","2","0","1908","584","2492"
"2020-05-04","NH","2588","24282","244","286","86","27114","26870","33","2","9","-1682","159","-1523"
"2020-05-04","NJ","128269","148951","647","0","7910","277867","277220","34","39","0","629","1525","2154"
"2020-05-04","NM","3850","74127","0","587","151","77977","77977","35","12","0","2915","118","3033"
"2020-05-04","NV","5491","40675","0","0","262","46166","46166","32","5","0","832","65","897"
"2020-05-04","NY","318953","688357","0","69331","19415","1007310","1007310","36","226","595","18861","2538","21399"
"2020-05-04","OH","20474","134681","0","3809","1056","155155","155155","39","18","40","4429","560","4989"
"2020-05-04","OK","4044","59804","0","753","238","63848","63848","40","0","10","0","72","72"
"2020-05-04","OR","2759","60698","0","608","109","63457","63457","41","0","10","1324","79","1403"
"2020-05-04","PA","50092","195498","0","0","2458","245590","245590","42","14","0","4124","825","4949"
"2020-05-04","PR","1843","9313","0","0","97","11156","11156","72","0","0","0","35","35"
"2020-05-04","RI","9652","64484","0","1061","341","74136","74136","44","21","48","2034","175","2209"
"2020-05-04","SC","6626","57562","0","1110","275","64188","64188","45","0","0","0","0","0"
"2020-05-04","SD","2668","16045","0","211","21","18713","18713","46","0","14","259","37","296"
"2020-05-04","TN","13571","197872","0","1143","219","211443","211443","47","9","8","6442","394","6836"
"2020-05-04","TX","32332","375066","0","0","884","407398","407398","48","17","0","16054","784","16838"
"2020-05-04","UT","5317","119344","0","441","50","124661","124661","49","0","5","2417","142","2559"
"2020-05-04","VA","19492","92801","478","4010","684","112771","112293","51","24","100","3470","821","4291"
"2020-05-04","VI","66","965","15","0","4","1046","1031","78","0","0","14","0","14"
"2020-05-04","VT","902","16430","0","0","52","17332","17332","50","0","0","373","5","378"
"2020-05-04","WA","15185","196820","0","0","834","212005","212005","53","4","0","4508","182","4690"
"2020-05-04","WI","8236","80467","226","1621","340","88929","88703","55","1","13","2470","272","2742"
"2020-05-04","WV","1206","52033","0","0","50","53239","53239","54","0","0","1586","15","1601"
"2020-05-04","WY","586","9868","0","60","7","10454","10454","56","0","0","228","7","235"
"2020-05-03","AK","368","21210","0","0","9","21578","21578","02","0","0","176","3","179"
"2020-05-03","AL","7725","84775","0","1035","290","92500","92500","01","2","12","0","291","291"
"2020-05-03","AR","3431","49459","0","427","76","52890","52890","05","3","13","1249","59","1308"
"2020-05-03","AS","0","57","0","0","0","57","57","60","0","0","0","0","0"
"2020-05-03","AZ","8640","72479","0","1348","362","81119","81119","04","14","9","2846","276","3122"
"2020-05-03","CA","53616","662135","0","0","2215","715751","715751","06","44","0","27529","1419","28948"
"2020-05-03","CO","16225","63681","0","2793","832","79906","79906","08","12","46","2500","457","2957"
"2020-05-03","CT","29287","73206","0","7758","2436","102493","102493","09","97","0","1713","523","2236"
"2020-05-03","DC","5016","18086","0","0","251","23102","23102","11","11","0","879","219","1098"
"2020-05-03","DE","5208","18529","0","0","177","23737","23737","10","9","0","455","170","625"
"2020-05-03","FL","36078","392111","1226","6244","1403","429415","428189","12","15","299","11562","615","12177"
"2020-05-03","GA","28602","146494","0","5393","1177","175096","175096","13","3","6","0","296","296"
"2020-05-03","GU","150","3152","0","0","5","3302","3302","66","0","0","112","2","114"
"2020-05-03","HI","620","32330","0","72","16","32950","32950","15","0","0","964","1","965"
"2020-05-03","IA","9169","44017","0","0","184","53186","53186","19","9","0","6309","528","6837"
"2020-05-03","ID","2061","27746","0","200","63","29807","29807","16","0","22","291","26","317"
"2020-05-03","IL","61499","257814","0","0","2618","319313","319313","17","59","0","16423","2994","19417"
"2020-05-03","IN","19933","88926","0","0","1246","108859","108859","18","17","0","4080","638","4718"
"2020-05-03","KS","5030","31748","0","547","134","36778","36778","20","3","6","1552","284","1836"
"2020-05-03","KY","4879","52770","0","1411","248","57649","57649","21","0","0","0","0","0"
"2020-05-03","LA","29340","146820","0","0","1969","176160","176160","22","19","0","3102","200","3302"
"2020-05-03","MA","68087","246559","0","6507","4004","314646","314646","25","158","129","13828","1824","15652"
"2020-05-03","MD","25462","107332","0","5051","1281","132794","132794","24","30","141","6283","989","7272"
"2020-05-03","ME","1185","19546","0","183","57","20731","20731","23","1","2","0","33","33"
"2020-05-03","MI","43754","168778","0","0","4049","212532","212532","26","29","0","10276","547","10823"
"2020-05-03","MN","6663","75969","0","1199","419","82632","82632","27","24","40","3190","435","3625"
"2020-05-03","MO","8386","74590","0","0","352","82976","82976","29","1","0","0","232","232"
"2020-05-03","MP","14","1321","0","0","2","1335","1335","69","0","0","387","0","387"
"2020-05-03","MS","7550","70043","0","1298","303","77593","77593","28","12","33","3009","109","3118"
"2020-05-03","MT","455","14552","0","61","16","15007","15007","30","0","0","372","0","372"
"2020-05-03","NC","11664","132171","0","0","422","143835","143835","37","2","0","4205","155","4360"
"2020-05-03","ND","1191","32162","0","90","25","33353","33353","38","1","0","1768","38","1806"
"2020-05-03","NE","5326","25936","0","0","76","31262","31262","31","3","0","1426","488","1914"
"2020-05-03","NH","2429","25964","220","277","84","28613","28393","33","3","7","3925","119","4044"
"2020-05-03","NJ","126744","148322","641","0","7871","275707","275066","34","129","0","9727","3027","12754"
"2020-05-03","NM","3732","71212","0","587","139","74944","74944","35","8","0","3607","219","3826"
"2020-05-03","NV","5426","39843","0","0","257","45269","45269","32","3","0","767","115","882"
"2020-05-03","NY","316415","669496","0","68736","19189","985911","985911","36","280","846","23402","3438","26840"
"2020-05-03","OH","19914","130252","0","3769","1038","150166","150166","39","17","57","3768","579","4347"
"2020-05-03","OK","3972","59804","0","743","238","63776","63776","40","0","0","0","121","121"
"2020-05-03","OR","2680","59374","0","598","109","62054","62054","41","0","3","1873","45","1918"
"2020-05-03","PA","49267","191374","0","0","2444","240641","240641","42","26","0","4303","962","5265"
"2020-05-03","PR","1808","9313","0","0","97","11121","11121","72","2","0","0","51","51"
"2020-05-03","RI","9477","62450","0","1013","320","71927","71927","44","24","36","1811","188","1999"
"2020-05-03","SC","6626","57562","0","1110","275","64188","64188","45","8","0","2435","137","2572"
"2020-05-03","SD","2631","15786","0","197","21","18417","18417","46","0","10","283","43","326"
"2020-05-03","TN","13177","191430","0","1135","210","204607","204607","47","1","10","7815","516","8331"
"2020-05-03","TX","31548","359012","0","0","867","390560","390560","48","20","0","8886","1026","9912"
"2020-05-03","UT","5175","116927","0","436","50","122102","122102","49","1","18","4104","194","4298"
"2020-05-03","VA","18671","89331","465","3910","660","108467","108002","51","44","172","4966","940","5906"
"2020-05-03","VI","66","951","29","0","4","1046","1017","78","0","0","29","0","29"
"2020-05-03","VT","897","16057","0","0","52","16954","16954","50","1","0","352","11","363"
"2020-05-03","WA","15003","192312","0","0","830","207315","207315","53","6","0","8225","366","8591"
"2020-05-03","WI","7964","77997","231","1608","339","86192","85961","55","5","17","2427","304","2731"
"2020-05-03","WV","1191","50447","0","0","50","51638","51638","54","2","0","2470","22","2492"
"2020-05-03","WY","579","9640","0","60","7","10219","10219","56","0","2","177","13","190"
"2020-05-02","AK","365","21034","0","0","9","21399","21399","02","0","0","1073","1","1074"
"2020-05-02","AL","7434","84775","0","1023","288","92209","92209","01","9","15","0","276","276"
"2020-05-02","AR","3372","48210","0","414","73","51582","51582","05","9","0","1855","51","1906"
"2020-05-02","AS","0","57","0","0","0","57","57","60","0","0","0","0","0"
"2020-05-02","AZ","8364","69633","0","1339","348","77997","77997","04","18","136","2716","402","3118"
"2020-05-02","CA","52197","634606","0","0","2171","686803","686803","06","98","0","30063","1755","31818"
"2020-05-02","CO","15768","61181","0","2747","820","76949","76949","08","43","50","4075","484","4559"
"2020-05-02","CT","28764","71493","0","7758","2339","100257","100257","09","0","0","0","0","0"
"2020-05-02","DC","4797","17207","0","0","240","22004","22004","11","9","0","730","139","869"
"2020-05-02","DE","5038","18074","0","0","168","23112","23112","10","9","0","407","120","527"
"2020-05-02","FL","35463","380549","0","5945","1388","416012","416012","12","74","150","12578","735","13313"
"2020-05-02","GA","28306","146494","0","5387","1174","174800","174800","13","20","118","5397","1036","6433"
"2020-05-02","GU","148","3040","0","0","5","3188","3188","66","0","0","181","2","183"
"2020-05-02","HI","619","31366","0","72","16","31985","31985","15","0","2","890","1","891"
"2020-05-02","IA","8641","37708","0","0","175","46349","46349","19","5","0","0","757","757"
"2020-05-02","ID","2035","27455","0","178","63","29490","29490","16","0","0","245","20","265"
"2020-05-02","IL","58505","241391","0","0","2559","299896","299896","17","102","0","12758","2450","15208"
"2020-05-02","IN","19295","84846","0","0","1229","104141","104141","18","54","0","3837","665","4502"
"2020-05-02","KS","4746","30196","0","541","131","34942","34942","20","1","7","1611","297","1908"
"2020-05-02","KY","4879","52770","0","1411","248","57649","57649","21","8","36","866","171","1037"
"2020-05-02","LA","29140","143718","0","0","1950","172858","172858","22","23","0","4178","429","4607"
"2020-05-02","MA","66263","232731","0","6378","3846","298994","298994","25","130","209","7406","1952","9358"
"2020-05-02","MD","24473","101049","0","4910","1251","125522","125522","24","59","192","3538","1001","4539"
"2020-05-02","ME","1152","19546","0","181","56","20698","20698","23","1","4","0","29","29"
"2020-05-02","MI","43207","158502","0","0","4020","201709","201709","26","154","0","10353","851","11204"
"2020-05-02","MN","6228","72779","0","1159","395","79007","79007","27","24","63","3680","498","4178"
"2020-05-02","MO","8154","74590","0","0","351","82744","82744","29","14","0","0","319","319"
"2020-05-02","MP","14","934","0","0","2","948","948","69","0","0","185","0","185"
"2020-05-02","MS","7441","67034","0","1265","291","74475","74475","28","10","39","2698","229","2927"
"2020-05-02","MT","455","14180","0","61","16","14635","14635","30","0","0","430","2","432"
"2020-05-02","NC","11509","127966","0","0","420","139475","139475","37","21","0","5057","586","5643"
"2020-05-02","ND","1153","30394","0","90","24","31547","31547","38","1","4","1976","46","2022"
"2020-05-02","NE","4838","24510","0","0","73","29348","29348","31","3","0","1406","557","1963"
"2020-05-02","NH","2310","22039","159","270","81","24508","24349","33","9","8","2136","164","2300"
"2020-05-02","NJ","123717","138595","676","0","7742","262988","262312","34","204","0","3240","2527","5767"
"2020-05-02","NM","3513","67605","0","587","131","71118","71118","35","8","51","3147","102","3249"
"2020-05-02","NV","5311","39076","0","0","254","44387","44387","32","11","0","708","84","792"
"2020-05-02","NY","312977","646094","0","67890","18909","959071","959071","36","299","710","26970","4663","31633"
"2020-05-02","OH","19335","126484","0","3712","1021","145819","145819","39","19","78","4721","592","5313"
"2020-05-02","OK","3851","59804","0","743","238","63655","63655","40","8","28","0","103","103"
"2020-05-02","OR","2635","57501","0","595","109","60136","60136","41","5","4","1904","56","1960"
"2020-05-02","PA","48305","187071","0","0","2418","235376","235376","42","64","0","6594","1334","7928"
"2020-05-02","PR","1757","9313","0","0","95","11070","11070","72","3","0","0","182","182"
"2020-05-02","RI","9289","60639","0","977","296","69928","69928","44","17","40","2953","327","3280"
"2020-05-02","SC","6489","55127","0","1110","267","61616","61616","45","11","0","2006","231","2237"
"2020-05-02","SD","2588","15503","0","187","21","18091","18091","46","0","8","665","63","728"
"2020-05-02","TN","12661","183615","0","1125","209","196276","196276","47","5","12","9374","770","10144"
"2020-05-02","TX","30522","350126","0","0","847","380648","380648","48","31","0","27580","1293","28873"
"2020-05-02","UT","4981","112823","0","418","49","117804","117804","49","3","15","5093","153","5246"
"2020-05-02","VA","17731","84365","458","3738","616","102554","102096","51","35","84","-5174","830","-4344"
"2020-05-02","VI","66","922","54","0","4","1042","988","78","0","0","111","0","111"
"2020-05-02","VT","886","15705","0","0","51","16591","16591","50","1","0","351","7","358"
"2020-05-02","WA","14637","184087","0","0","824","198724","198724","53","10","0","4433","310","4743"
"2020-05-02","WI","7660","75570","231","1591","334","83461","83230","55","7","47","3004","346","3350"
"2020-05-02","WV","1169","47977","0","0","48","49146","49146","54","2","0","2269","33","2302"
"2020-05-02","WY","566","9463","0","58","7","10029","10029","56","0","2","327","7","334"
"2020-05-01","AK","364","19961","0","0","9","20325","20325","02","0","0","1197","9","1206"
"2020-05-01","AL","7158","84775","0","1008","279","91933","91933","01","10","30","4598","139","4737"
"2020-05-01","AR","3321","46355","0","414","64","49676","49676","05","3","12","1231","66","1297"
"2020-05-01","AS","0","57","0","0","0","57","57","60","0","0","54","0","54"
"2020-05-01","AZ","7962","66917","0","1203","330","74879","74879","04","10","34","2779","314","3093"
"2020-05-01","CA","50442","604543","0","0","2073","654985","654985","06","91","0","28123","1525","29648"
"2020-05-01","CO","15284","57106","0","2697","777","72390","72390","08","11","76","805","526","1331"
"2020-05-01","CT","28764","71493","0","7758","2339","100257","100257","09","82","7758","2060","1064","3124"
"2020-05-01","DC","4658","16477","0","0","231","21135","21135","11","7","0","721","335","1056"
"2020-05-01","DE","4918","17667","0","0","159","22585","22585","10","7","0","581","184","765"
"2020-05-01","FL","34728","367971","0","5795","1314","402699","402699","12","24","0","19256","1038","20294"
"2020-05-01","GA","27270","141097","0","5269","1154","168367","168367","13","34","113","18208","1115","19323"
"2020-05-01","GU","146","2859","0","0","5","3005","3005","66","0","0","897","0","897"
"2020-05-01","HI","618","30476","0","70","16","31094","31094","15","0","1","449","5","454"
"2020-05-01","IA","7884","37708","0","0","170","45592","45592","19","8","0","2186","739","2925"
"2020-05-01","ID","2015","27210","0","178","63","29225","29225","16","3","3","501","31","532"
"2020-05-01","IL","56055","228633","0","0","2457","284688","284688","17","102","0","11684","3137","14821"
"2020-05-01","IN","18630","81009","0","0","1175","99639","99639","18","61","0","3846","795","4641"
"2020-05-01","KS","4449","28585","0","534","130","33034","33034","20","1","11","1197","211","1408"
"2020-05-01","KY","4708","51904","0","1375","240","56612","56612","21","5","16","2342","169","2511"
"2020-05-01","LA","28711","139540","0","0","1927","168251","168251","22","65","0","6232","710","6942"
"2020-05-01","MA","64311","225325","0","6169","3716","289636","289636","25","154","227","11883","2106","13989"
"2020-05-01","MD","23472","97511","0","4718","1192","120983","120983","24","52","159","4894","1730","6624"
"2020-05-01","ME","1123","19546","0","177","55","20669","20669","23","2","7","0","28","28"
"2020-05-01","MI","42356","148149","0","0","3866","190505","190505","26","77","0","9261","977","10238"
"2020-05-01","MN","5730","69099","0","1096","371","74829","74829","27","28","52","3959","594","4553"
"2020-05-01","MO","7835","74590","0","0","337","82425","82425","29","8","0","1465","273","1738"
"2020-05-01","MP","14","749","0","0","2","763","763","69","0","0","164","0","164"
"2020-05-01","MS","7212","64336","0","1226","281","71548","71548","28","20","51","4811","397","5208"
"2020-05-01","MT","453","13750","0","61","16","14203","14203","30","0","0","289","0","289"
"2020-05-01","NC","10923","122909","0","0","399","133832","133832","37","21","0","5382","414","5796"
"2020-05-01","ND","1107","28418","0","86","23","29525","29525","38","4","1","2025","40","2065"
"2020-05-01","NE","4281","23104","0","0","70","27385","27385","31","2","0","1567","497","2064"
"2020-05-01","NH","2146","19903","302","262","72","22351","22049","33","6","3","36","92","128"
"2020-05-01","NJ","121190","135355","583","0","7538","257128","256545","34","310","0","6089","2538","8627"
"2020-05-01","NM","3411","64458","0","536","123","67869","67869","35","11","0","2586","198","2784"
"2020-05-01","NV","5227","38368","0","0","243","43595","43595","32","6","0","1380","229","1609"
"2020-05-01","NY","308314","619124","0","67180","18610","927438","927438","36","289","811","22860","3942","26802"
"2020-05-01","OH","18743","121763","0","3634","1002","140506","140506","39","27","101","5900","716","6616"
"2020-05-01","OK","3748","59804","0","715","230","63552","63552","40","8","12","0","130","130"
"2020-05-01","OR","2579","55597","0","591","104","58176","58176","41","1","13","2075","69","2144"
"2020-05-01","PA","46971","180477","0","0","2354","227448","227448","42","62","0","4875","1208","6083"
"2020-05-01","PR","1575","9313","0","0","92","10888","10888","72","0","0","0","36","36"
"2020-05-01","RI","8962","57686","0","937","279","66648","66648","44","13","41","2597","341","2938"
"2020-05-01","SC","6258","53121","0","1110","256","59379","59379","45","12","110","2704","163","2867"
"2020-05-01","SD","2525","14838","0","179","21","17363","17363","46","4","6","259","76","335"
"2020-05-01","TN","11891","174241","0","1113","204","186132","186132","47","5","68","7350","1156","8506"
"2020-05-01","TX","29229","322546","0","0","816","351775","351775","48","34","0","20333","1142","21475"
"2020-05-01","UT","4828","107730","0","403","46","112558","112558","49","0","13","3901","156","4057"
"2020-05-01","VA","16901","89539","468","3654","581","106908","106440","51","29","0","13876","1055","14931"
"2020-05-01","VI","66","811","68","0","4","945","877","78","0","0","4","0","4"
"2020-05-01","VT","879","15354","0","0","50","16233","16233","50","1","0","568","13","581"
"2020-05-01","WA","14327","179654","0","0","814","193981","193981","53","13","0","5924","257","6181"
"2020-05-01","WI","7314","72566","218","1544","327","80098","79880","55","11","32","3172","460","3632"
"2020-05-01","WV","1136","45708","0","0","46","46844","46844","54","5","0","2285","18","2303"
"2020-05-01","WY","559","9136","0","56","7","9695","9695","56","0","0","234","15","249"
"2020-04-30","AK","355","18764","0","0","9","19119","19119","02","0","0","0","0","0"
"2020-04-30","AL","7019","80177","0","978","269","87196","87196","01","24","33","6570","177","6747"
"2020-04-30","AR","3255","45124","0","402","61","48379","48379","05","2","13","2867","63","2930"
"2020-04-30","AS","0","3","17","0","0","20","3","60","0","0","0","0","0"
"2020-04-30","AZ","7648","64138","0","1169","320","71786","71786","04","16","38","2527","446","2973"
"2020-04-30","CA","48917","576420","0","0","1982","625337","625337","06","95","0","19781","2417","22198"
"2020-04-30","CO","14758","56301","0","2621","766","71059","71059","08","6","11","1587","23","1610"
"2020-04-30","CT","27700","69433","0","0","2257","97133","97133","09","89","0","1382","933","2315"
"2020-04-30","DC","4323","15756","0","0","224","20079","20079","11","19","0","633","217","850"
"2020-04-30","DE","4734","17086","0","0","152","21820","21820","10","8","0","203","79","282"
"2020-04-30","FL","33690","348715","1187","5795","1290","383592","382405","12","50","171","8420","497","8917"
"2020-04-30","GA","26155","122889","0","5156","1120","149044","149044","13","27","100","4522","583","5105"
"2020-04-30","GU","146","1962","0","0","5","2108","2108","66","0","0","260","1","261"
"2020-04-30","HI","613","30027","0","69","16","30640","30640","15","0","0","1018","4","1022"
"2020-04-30","IA","7145","35522","0","0","162","42667","42667","19","14","0","1028","302","1330"
"2020-04-30","ID","1984","26709","0","175","60","28693","28693","16","0","2","279","32","311"
"2020-04-30","IL","52918","216949","0","0","2355","269867","269867","17","140","0","10637","2563","13200"
"2020-04-30","IN","17835","77163","0","0","1114","94998","94998","18","49","0","2795","653","3448"
"2020-04-30","KS","4238","27388","0","523","129","31626","31626","20","4","8","1668","500","2168"
"2020-04-30","KY","4539","49562","0","1359","235","54101","54101","21","10","28","1526","164","1690"
"2020-04-30","LA","28001","133308","0","0","1862","161309","161309","22","60","0","4400","341","4741"
"2020-04-30","MA","62205","213442","0","5942","3562","275647","275647","25","157","184","8089","1940","10029"
"2020-04-30","MD","21742","92617","0","4559","1140","114359","114359","24","62","157","2537","893","3430"
"2020-04-30","ME","1095","19546","0","170","53","20641","20641","23","1","4","0","39","39"
"2020-04-30","MI","41379","138888","0","0","3789","180267","180267","26","119","0","6935","980","7915"
"2020-04-30","MN","5136","65140","0","1044","343","70276","70276","27","24","94","3040","492","3532"
"2020-04-30","MO","7562","73125","0","0","329","80687","80687","29","11","0","3391","137","3528"
"2020-04-30","MP","14","585","0","0","2","599","599","69","0","0","375","0","375"
"2020-04-30","MS","6815","59525","0","1175","261","66340","66340","28","11","49","0","246","246"
"2020-04-30","MT","453","13461","0","61","16","13914","13914","30","0","0","384","2","386"
"2020-04-30","NC","10509","117527","0","0","378","128036","128036","37","24","0","9035","561","9596"
"2020-04-30","ND","1067","26393","0","85","19","27460","27460","38","0","3","1890","34","1924"
"2020-04-30","NE","3784","21537","0","0","68","25321","25321","31","13","0","1280","410","1690"
"2020-04-30","NH","2054","19867","272","259","66","22193","21921","33","6","10","1131","44","1175"
"2020-04-30","NJ","118652","129266","478","0","7228","248396","247918","34","458","0","4212","2388","6600"
"2020-04-30","NM","3213","61872","0","536","112","65085","65085","35","2","27","3101","239","3340"
"2020-04-30","NV","4998","36988","0","0","237","41986","41986","32","7","0","858","100","958"
"2020-04-30","NY","304372","596264","0","66369","18321","900636","900636","36","306","972","23474","4681","28155"
"2020-04-30","OH","18027","115863","0","3533","975","133890","133890","39","38","112","4258","724","4982"
"2020-04-30","OK","3618","59804","0","703","222","63422","63422","40","8","10","2010","145","2155"
"2020-04-30","OR","2510","53522","0","578","103","56032","56032","41","2","9","1496","64","1560"
"2020-04-30","PA","45763","175602","0","0","2292","221365","221365","42","97","0","5085","1397","6482"
"2020-04-30","PR","1539","9313","0","0","92","10852","10852","72","6","0","0","106","106"
"2020-04-30","RI","8621","55089","0","896","266","63710","63710","44","15","146","3171","374","3545"
"2020-04-30","SC","6095","50417","0","1000","244","56512","56512","45","41","0","2081","214","2295"
"2020-04-30","SD","2449","14579","0","173","17","17028","17028","46","4","8","119","76","195"
"2020-04-30","TN","10735","166891","0","1045","199","177626","177626","47","4","32","8708","369","9077"
"2020-04-30","TX","28087","302213","0","0","782","330300","330300","48","50","0","14477","1033","15510"
"2020-04-30","UT","4672","103829","0","390","46","108501","108501","49","1","7","2546","177","2723"
"2020-04-30","VA","15846","75663","583","3654","552","92092","91509","51","30","46","4684","885","5569"
"2020-04-30","VI","66","807","43","0","4","916","873","78","0","0","75","4","79"
"2020-04-30","VT","866","14786","0","0","49","15652","15652","50","2","0","219","4","223"
"2020-04-30","WA","14070","173730","0","0","801","187800","187800","53","15","0","5057","228","5285"
"2020-04-30","WI","6854","69394","195","1512","316","76443","76248","55","8","23","2764","334","3098"
"2020-04-30","WV","1118","43423","0","0","41","44541","44541","54","3","0","1447","23","1470"
"2020-04-30","WY","544","8902","0","56","7","9446","9446","56","0","0","221","8","229"
"2020-04-29","AK","355","18764","0","0","9","19119","19119","02","0","0","2026","4","2030"
"2020-04-29","AL","6842","73607","0","945","245","80449","80449","01","3","34","4467","155","4622"
"2020-04-29","AR","3192","42257","0","389","59","45449","45449","05","7","389","4697","81","4778"
"2020-04-29","AS","0","3","17","0","0","20","3","60","0","0","0","0","0"
"2020-04-29","AZ","7202","61611","0","1131","304","68813","68813","04","11","36","1121","254","1375"
"2020-04-29","CA","46500","556639","0","0","1887","603139","603139","06","78","0","24062","1469","25531"
"2020-04-29","CO","14735","54714","0","2610","760","69449","69449","08","54","125","2252","856","3108"
"2020-04-29","CT","26767","68051","0","0","2168","94818","94818","09","79","0","1618","455","2073"
"2020-04-29","DC","4106","15123","0","0","205","19229","19229","11","15","0","232","112","344"
"2020-04-29","DE","4655","16883","0","0","144","21538","21538","10","7","0","278","80","358"
"2020-04-29","FL","33193","340295","1252","5624","1240","374740","373488","12","86","358","6266","347","6613"
"2020-04-29","GA","25572","118367","0","5056","1093","143939","143939","13","67","242","2962","957","3919"
"2020-04-29","GU","145","1702","0","0","5","1847","1847","66","0","0","164","0","164"
"2020-04-29","HI","609","29009","0","69","16","29618","29618","15","0","1","433","2","435"
"2020-04-29","IA","6843","34494","0","0","148","41337","41337","19","12","0","1047","467","1514"
"2020-04-29","ID","1952","26430","0","173","60","28382","28382","16","2","1","8295","35","8330"
"2020-04-29","IL","50355","206312","0","0","2215","256667","256667","17","90","0","12225","2253","14478"
"2020-04-29","IN","17182","74368","0","0","1065","91550","91550","18","164","0","3775","594","4369"
"2020-04-29","KS","3738","25720","0","515","125","29458","29458","20","1","11","1121","247","1368"
"2020-04-29","KY","4375","48036","0","1331","225","52411","52411","21","12","50","3383","229","3612"
"2020-04-29","LA","27660","128908","0","0","1802","156568","156568","22","44","0","5086","374","5460"
"2020-04-29","MA","60265","205353","0","5758","3405","265618","265618","25","252","243","9155","1963","11118"
"2020-04-29","MD","20849","90080","0","4402","1078","110929","110929","24","62","134","2408","736","3144"
"2020-04-29","ME","1056","19546","0","166","52","20602","20602","23","1","3","2762","16","2778"
"2020-04-29","MI","40399","131953","0","0","3670","172352","172352","26","103","0","6410","1137","7547"
"2020-04-29","MN","4644","62100","0","950","319","66744","66744","27","18","38","2452","463","2915"
"2020-04-29","MO","7425","69734","0","0","318","77159","77159","29","4","0","3534","122","3656"
"2020-04-29","MP","14","210","0","0","2","224","224","69","0","0","159","0","159"
"2020-04-29","MS","6569","59525","0","1126","250","66094","66094","28","11","38","1455","227","1682"
"2020-04-29","MT","451","13077","0","61","16","13528","13528","30","1","0","337","0","337"
"2020-04-29","NC","9948","108492","0","0","354","118440","118440","37","12","0","5308","380","5688"
"2020-04-29","ND","1033","24503","0","82","19","25536","25536","38","0","3","1771","42","1813"
"2020-04-29","NE","3374","20257","0","0","55","23631","23631","31","0","0","10","16","26"
"2020-04-29","NH","2010","18736","81","249","60","20827","20746","33","0","3","529","72","601"
"2020-04-29","NJ","116264","125054","617","0","6770","241935","241318","34","328","0","4551","2408","6959"
"2020-04-29","NM","2974","58771","0","509","110","61745","61745","35","6","28","2791","151","2942"
"2020-04-29","NV","4898","36130","0","0","230","41028","41028","32","11","0","816","93","909"
"2020-04-29","NY","299691","572790","0","65397","18015","872481","872481","36","377","1079","22902","4585","27487"
"2020-04-29","OH","17303","111605","0","3421","937","128908","128908","39","138","81","5027","1175","6202"
"2020-04-29","OK","3473","57794","0","693","214","61267","61267","40","7","37","1505","63","1568"
"2020-04-29","OR","2446","52026","0","569","101","54472","54472","41","9","15","3182","92","3274"
"2020-04-29","PA","44366","170517","0","0","2195","214883","214883","42","479","0","4693","1102","5795"
"2020-04-29","PR","1433","9313","1940","0","86","12686","10746","72","0","0","0","33","33"
"2020-04-29","RI","8247","51918","0","750","251","60165","60165","44","12","18","2151","321","2472"
"2020-04-29","SC","5881","48336","0","1000","203","54217","54217","45","26","56","1804","268","2072"
"2020-04-29","SD","2373","14460","0","165","13","16833","16833","46","2","8","161","60","221"
"2020-04-29","TN","10366","158183","0","1013","195","168549","168549","47","7","119","6307","314","6621"
"2020-04-29","TX","27054","287736","0","0","732","314790","314790","48","42","0","13523","883","14406"
"2020-04-29","UT","4495","101283","0","383","45","105778","105778","49","0","13","3187","152","3339"
"2020-04-29","VA","14961","70979","620","3608","522","86560","85940","51","30","186","2020","622","2642"
"2020-04-29","VI","62","732","78","0","4","872","794","78","0","0","13","3","16"
"2020-04-29","VT","862","14567","0","0","47","15429","15429","50","0","0","214","0","214"
"2020-04-29","WA","13842","168673","0","0","786","182515","182515","53","21","0","2680","156","2836"
"2020-04-29","WI","6520","66630","227","1489","308","73377","73150","55","8","33","3095","231","3326"
"2020-04-29","WV","1095","41976","0","0","38","43071","43071","54","1","0","0","16","16"
"2020-04-29","WY","536","8681","0","56","7","9217","9217","56","0","0","455","147","602"
"2020-04-28","AK","351","16738","0","0","9","17089","17089","02","0","0","827","6","833"
"2020-04-28","AL","6687","69140","0","911","242","75827","75827","01","20","39","1642","188","1830"
"2020-04-28","AR","3111","37560","0","0","52","40671","40671","05","2","0","120","94","214"
"2020-04-28","AS","0","3","17","0","0","20","3","60","0","0","0","0","0"
"2020-04-28","AZ","6948","60490","0","1095","293","67438","67438","04","18","44","663","232","895"
"2020-04-28","CA","45031","532577","0","0","1809","577608","577608","06","54","0","22632","1567","24199"
"2020-04-28","CO","13879","52462","0","2485","706","66341","66341","08","26","47","2629","438","3067"
"2020-04-28","CT","26312","66433","0","0","2089","92745","92745","09","91","0","11891","1043","12934"
"2020-04-28","DC","3994","14891","0","0","190","18885","18885","11","5","0","367","102","469"
"2020-04-28","DE","4575","16605","0","0","137","21180","21180","10","12","0","1151","413","1564"
"2020-04-28","FL","32846","334029","1216","5266","1154","368091","366875","12","53","55","9704","708","10412"
"2020-04-28","GA","24615","115405","0","4814","1026","140020","140020","13","55","133","12149","702","12851"
"2020-04-28","GU","145","1538","0","0","5","1683","1683","66","0","0","114","1","115"
"2020-04-28","HI","607","28576","0","68","16","29183","29183","15","2","0","172","1","173"
"2020-04-28","IA","6376","33447","0","0","136","39823","39823","19","9","0","1165","508","1673"
"2020-04-28","ID","1917","18135","0","172","58","20052","20052","16","2","3","137","20","157"
"2020-04-28","IL","48102","194087","0","0","2125","242189","242189","17","142","0","12342","2219","14561"
"2020-04-28","IN","16588","70593","0","0","901","87181","87181","18","57","0","2078","627","2705"
"2020-04-28","KS","3491","24599","0","504","124","28090","28090","20","4","8","760","163","923"
"2020-04-28","KY","4146","44653","0","1281","213","48799","48799","21","5","7","253","72","325"
"2020-04-28","LA","27286","123822","0","0","1758","151108","151108","22","61","0","3901","218","4119"
"2020-04-28","MA","58302","196198","0","5515","3153","254500","254500","25","150","278","7773","1840","9613"
"2020-04-28","MD","20113","87672","0","4268","1016","107785","107785","24","71","167","2183","626","2809"
"2020-04-28","ME","1040","16784","0","163","51","17824","17824","23","0","2","0","17","17"
"2020-04-28","MI","39262","125543","0","0","3567","164805","164805","26","160","0","5993","1052","7045"
"2020-04-28","MN","4181","59648","0","912","301","63829","63829","27","15","51","2196","365","2561"
"2020-04-28","MO","7303","66200","0","0","314","73503","73503","29","26","0","2265","132","2397"
"2020-04-28","MP","14","51","0","0","2","65","65","69","0","0","0","0","0"
"2020-04-28","MS","6342","58070","0","1088","239","64412","64412","28","10","28","702","248","950"
"2020-04-28","MT","451","12740","0","61","15","13191","13191","30","1","0","156","2","158"
"2020-04-28","NC","9568","103184","0","0","342","112752","112752","37","36","0","2406","426","2832"
"2020-04-28","ND","991","22732","0","79","19","23723","23723","38","0","2","1240","49","1289"
"2020-04-28","NE","3358","20247","0","0","55","23605","23605","31","-1","0","912","330","1242"
"2020-04-28","NH","1938","18207","223","246","60","20368","20145","33","0","4","347","74","421"
"2020-04-28","NJ","113856","120503","0","0","6442","234359","234359","34","398","0","3916","2668","6584"
"2020-04-28","NM","2823","55980","0","481","104","58803","58803","35","5","69","2091","97","2188"
"2020-04-28","NV","4805","35314","0","0","219","40119","40119","32","13","0","1191","115","1306"
"2020-04-28","NY","295106","549888","0","64318","17638","844994","844994","36","335","748","15789","3110","18899"
"2020-04-28","OH","16128","106578","0","3340","799","122706","122706","39","46","108","2886","429","3315"
"2020-04-28","OK","3410","56289","0","656","207","59699","59699","40","10","0","6398","130","6528"
"2020-04-28","OR","2354","48844","0","554","92","51198","51198","41","0","0","0","0","0"
"2020-04-28","PA","43264","165824","0","0","1716","209088","209088","42","119","0","4452","1214","5666"
"2020-04-28","PR","1400","9313","1940","0","86","12653","10713","72","2","0","0","11","11"
"2020-04-28","RI","7926","49767","0","732","239","57693","57693","44","6","14","1590","218","1808"
"2020-04-28","SC","5613","46532","0","944","177","52145","52145","45","3","0","1261","123","1384"
"2020-04-28","SD","2313","14299","0","157","11","16612","16612","46","0","7","169","68","237"
"2020-04-28","TN","10052","151876","0","894","188","161928","161928","47","4","57","7392","134","7526"
"2020-04-28","TX","26171","274213","0","0","690","300384","300384","48","27","0","8993","874","9867"
"2020-04-28","UT","4343","98096","0","370","45","102439","102439","49","4","21","2134","110","2244"
"2020-04-28","VA","14339","68959","560","3422","492","83858","83298","51","34","124","1815","804","2619"
"2020-04-28","VI","59","719","57","0","4","835","778","78","0","0","3","0","3"
"2020-04-28","VT","862","14353","0","0","47","15215","15215","50","0","0","135","7","142"
"2020-04-28","WA","13686","165993","0","0","765","179679","179679","53","16","0","4037","165","4202"
"2020-04-28","WI","6289","63535","193","1456","300","70017","69824","55","19","41","2224","208","2432"
"2020-04-28","WV","1079","41976","0","0","37","43055","43055","54","1","0","0","16","16"
"2020-04-28","WY","389","8226","0","56","7","8615","8615","56","0","2","429","19","448"
"2020-04-27","AK","345","15911","0","0","9","16256","16256","02","0","0","75","4","79"
"2020-04-27","AL","6499","67498","0","872","222","73997","73997","01","6","27","217","229","446"
"2020-04-27","AR","3017","37440","0","0","50","40457","40457","05","1","0","912","76","988"
"2020-04-27","AS","0","3","17","0","0","20","3","60","0","0","0","0","0"
"2020-04-27","AZ","6716","59827","0","1051","275","66543","66543","04","0","14","1542","190","1732"
"2020-04-27","CA","43464","509945","0","0","1755","553409","553409","06","45","0","26025","1300","27325"
"2020-04-27","CO","13441","49833","0","2438","680","63274","63274","08","8","28","3010","473","3483"
"2020-04-27","CT","25269","54542","0","0","1998","79811","79811","09","74","0","0","0","0"
"2020-04-27","DC","3892","14524","0","0","185","18416","18416","11","7","0","297","51","348"
"2020-04-27","DE","4162","15454","0","0","125","19616","19616","10","5","0","239","128","367"
"2020-04-27","FL","32138","324325","1099","5211","1101","357562","356463","12","7","56","11240","610","11850"
"2020-04-27","GA","23913","103256","0","4681","971","127169","127169","13","59","322","3434","512","3946"
"2020-04-27","GU","144","1424","0","0","5","1568","1568","66","0","0","37","3","40"
"2020-04-27","HI","606","28404","0","68","14","29010","29010","15","0","0","524","3","527"
"2020-04-27","IA","5868","32282","0","0","127","38150","38150","19","9","0","1668","392","2060"
"2020-04-27","ID","1897","17998","0","169","56","19895","19895","16","0","0","320","10","330"
"2020-04-27","IL","45883","181745","0","0","1983","227628","227628","17","50","0","10696","1980","12676"
"2020-04-27","IN","15961","68515","0","0","844","84476","84476","18","31","0","1819","949","2768"
"2020-04-27","KS","3328","23839","0","496","120","27167","27167","20","2","11","786","154","940"
"2020-04-27","KY","4074","44400","0","1274","208","48474","48474","21","3","8","1747","169","1916"
"2020-04-27","LA","27068","119921","0","0","1697","146989","146989","22","27","0","3658","295","3953"
"2020-04-27","MA","56462","188425","0","5237","3003","244887","244887","25","104","133","7263","1524","8787"
"2020-04-27","MD","19487","85489","0","4101","945","104976","104976","24","35","139","7405","906","8311"
"2020-04-27","ME","1023","16784","0","161","51","17807","17807","23","1","2","0","8","8"
"2020-04-27","MI","38210","119550","0","0","3407","157760","157760","26","92","0","6322","432","6754"
"2020-04-27","MN","3816","57452","0","861","286","61268","61268","27","14","32","2067","214","2281"
"2020-04-27","MO","7171","63935","0","0","288","71106","71106","29","14","0","1184","174","1358"
"2020-04-27","MP","14","51","0","0","2","65","65","69","0","0","0","0","0"
"2020-04-27","MS","6094","57368","0","1060","229","63462","63462","28","2","59","2491","183","2674"
"2020-04-27","MT","449","12584","0","61","14","13033","13033","30","0","0","170","1","171"
"2020-04-27","NC","9142","100778","0","0","306","109920","109920","37","7","0","1714","312","2026"
"2020-04-27","ND","942","21492","0","77","19","22434","22434","38","2","6","1642","75","1717"
"2020-04-27","NE","3028","19335","0","0","56","22363","22363","31","3","0","839","296","1135"
"2020-04-27","NH","1864","17860","270","242","60","19994","19724","33","0","4","896","77","973"
"2020-04-27","NJ","111188","116587","0","0","6044","227775","227775","34","106","0","2481","2150","4631"
"2020-04-27","NM","2726","53889","0","412","99","56615","56615","35","6","0","2814","66","2880"
"2020-04-27","NV","4690","34123","0","0","206","38813","38813","32","0","0","539","88","627"
"2020-04-27","NY","291996","534099","0","63570","17303","826095","826095","36","337","1044","16794","3951","20745"
"2020-04-27","OH","15699","103692","0","3232","753","119391","119391","39","25","54","3269","-264","3005"
"2020-04-27","OK","3280","49891","0","656","197","53171","53171","40","2","3","0","27","27"
"2020-04-27","OR","2354","48844","0","554","92","51198","51198","41","1","8","2191","43","2234"
"2020-04-27","PA","42050","161372","0","0","1597","203422","203422","42","47","0","3944","885","4829"
"2020-04-27","PR","1389","9313","1940","0","84","12642","10702","72","0","0","0","18","18"
"2020-04-27","RI","7708","48177","0","718","233","55885","55885","44","7","27","2213","269","2482"
"2020-04-27","SC","5490","45271","0","944","174","50761","50761","45","0","0","0","0","0"
"2020-04-27","SD","2245","14130","0","150","11","16375","16375","46","0","15","68","33","101"
"2020-04-27","TN","9918","144484","0","837","184","154402","154402","47","3","9","5930","251","6181"
"2020-04-27","TX","25297","265220","0","0","663","290517","290517","48","15","0","13830","666","14496"
"2020-04-27","UT","4233","95962","0","349","41","100195","100195","49","0","4","4383","110","4493"
"2020-04-27","VA","13535","67144","542","3298","458","81221","80679","51","10","1284","3514","565","4079"
"2020-04-27","VI","59","716","5","0","4","780","775","78","0","0","16","2","18"
"2020-04-27","VT","855","14218","0","0","47","15073","15073","50","1","0","272","4","276"
"2020-04-27","WA","13521","161956","0","0","749","175477","175477","53","11","0","37","0","37"
"2020-04-27","WI","6081","61311","204","1415","281","67596","67392","55","9","18","2076","170","2246"
"2020-04-27","WV","1063","41976","0","0","36","43039","43039","54","2","0","3957","19","3976"
"2020-04-27","WY","370","7797","0","54","7","8167","8167","56","0","0","0","8","8"
"2020-04-26","AK","341","15836","0","0","9","16177","16177","02","0","0","443","2","445"
"2020-04-26","AL","6270","67281","0","845","216","73551","73551","01","4","6","2074","133","2207"
"2020-04-26","AR","2941","36528","0","291","49","39469","39469","05","2","0","1304","112","1416"
"2020-04-26","AS","0","3","17","0","0","20","3","60","0","0","0","0","0"
"2020-04-26","AZ","6526","58285","0","1037","275","64811","64811","04","9","15","2057","246","2303"
"2020-04-26","CA","42164","483920","0","0","1710","526084","526084","06","59","0","19022","1027","20049"
"2020-04-26","CO","12968","46823","0","2410","672","59791","59791","08","-2","44","2290","712","3002"
"2020-04-26","CT","25269","54542","0","0","1924","79811","79811","09","62","0","1522","687","2209"
"2020-04-26","DC","3841","14227","0","0","178","18068","18068","11","13","0","624","142","766"
"2020-04-26","DE","4034","15215","0","0","120","19249","19249","10","8","0","1093","458","1551"
"2020-04-26","FL","31528","313085","1183","5155","1094","345796","344613","12","19","110","10825","689","11514"
"2020-04-26","GA","23401","99822","0","4359","912","123223","123223","13","8","33","3503","706","4209"
"2020-04-26","GU","141","1387","0","0","5","1528","1528","66","0","0","79","0","79"
"2020-04-26","HI","603","27880","0","68","14","28483","28483","15","1","1","441","2","443"
"2020-04-26","IA","5476","30614","0","0","118","36090","36090","19","6","0","1356","384","1740"
"2020-04-26","ID","1887","17678","0","169","56","19565","19565","16","2","1","187","17","204"
"2020-04-26","IL","43903","171049","0","0","1933","214952","214952","17","59","0","11209","2126","13335"
"2020-04-26","IN","15012","66696","0","0","813","81708","81708","18","28","0","1317","617","1934"
"2020-04-26","KS","3174","23053","0","485","118","26227","26227","20","1","11","910","118","1028"
"2020-04-26","KY","3905","42653","0","1266","205","46558","46558","21","5","123","1470","126","1596"
"2020-04-26","LA","26773","116263","0","0","1670","143036","143036","22","26","0","3773","261","4034"
"2020-04-26","MA","54938","181162","0","5104","2899","236100","236100","25","22","139","7665","1590","9255"
"2020-04-26","MD","18581","78084","0","3962","910","96665","96665","24","35","202","6727","815","7542"
"2020-04-26","ME","1015","16784","0","159","50","17799","17799","23","0","3","0","25","25"
"2020-04-26","MI","37778","113228","0","0","3315","151006","151006","26","41","0","6387","575","6962"
"2020-04-26","MN","3602","55385","0","829","272","58987","58987","27","28","32","2234","156","2390"
"2020-04-26","MO","6997","62751","0","0","274","69748","69748","29","1","0","2359","171","2530"
"2020-04-26","MP","14","51","0","0","2","65","65","69","0","0","0","0","0"
"2020-04-26","MS","5911","54877","0","1001","227","60788","60788","28","6","5","1638","193","1831"
"2020-04-26","MT","448","12414","0","61","14","12862","12862","30","0","0","362","3","365"
"2020-04-26","NC","8830","99064","0","0","299","107894","107894","37","10","0","2422","207","2629"
"2020-04-26","ND","867","19850","0","71","17","20717","20717","38","1","1","1303","64","1367"
"2020-04-26","NE","2732","18496","0","0","53","21228","21228","31","3","0","944","311","1255"
"2020-04-26","NH","1787","16964","550","238","60","19301","18751","33","7","14","957","67","1024"
"2020-04-26","NJ","109038","114106","0","0","5938","223144","223144","34","75","0","5943","3515","9458"
"2020-04-26","NM","2660","51075","0","412","93","53735","53735","35","9","0","2086","139","2225"
"2020-04-26","NV","4602","33584","0","0","206","38186","38186","32","2","0","915","63","978"
"2020-04-26","NY","288045","517305","0","62526","16966","805350","805350","36","367","1067","21880","5902","27782"
"2020-04-26","OH","15963","100423","0","3178","728","116386","116386","39","17","63","4027","376","4403"
"2020-04-26","OK","3253","49891","0","653","195","53144","53144","40","1","16","0","60","60"
"2020-04-26","OR","2311","46653","0","546","91","48964","48964","41","4","10","1529","58","1587"
"2020-04-26","PA","41165","157428","0","0","1550","198593","198593","42","13","0","4542","1116","5658"
"2020-04-26","PR","1371","9313","1940","0","84","12624","10684","72","1","0","0","64","64"
"2020-04-26","RI","7439","45964","0","691","226","53403","53403","44","11","115","2202","310","2512"
"2020-04-26","SC","5490","45271","0","944","174","50761","50761","45","8","0","1510","237","1747"
"2020-04-26","SD","2212","14062","0","135","11","16274","16274","46","1","7","613","65","678"
"2020-04-26","TN","9667","138554","0","828","181","148221","148221","47","3","7","6337","478","6815"
"2020-04-26","TX","24631","251390","0","0","648","276021","276021","48","25","0","12347","858","13205"
"2020-04-26","UT","4123","91579","0","345","41","95702","95702","49","0","16","5321","175","5496"
"2020-04-26","VA","12970","63630","539","2014","448","77139","76600","51","12","72","3354","604","3958"
"2020-04-26","VI","57","700","19","0","4","776","757","78","1","0","7","2","9"
"2020-04-26","VT","851","13946","0","0","46","14797","14797","50","0","0","107","8","115"
"2020-04-26","WA","13521","161919","0","0","738","175440","175440","53","73","0","0","0","0"
"2020-04-26","WI","5911","59235","197","1397","272","65343","65146","55","6","21","2097","224","2321"
"2020-04-26","WV","1044","38019","0","0","34","39063","39063","54","2","0","6073","24","6097"
"2020-04-26","WY","362","7797","0","54","7","8159","8159","56","0","0","0","13","13"
"2020-04-25","AK","339","15393","0","0","9","15732","15732","02","0","0","3451","0","3451"
"2020-04-25","AL","6137","65207","0","839","212","71344","71344","01","15","71","18344","305","18649"
"2020-04-25","AR","2829","35224","0","291","47","38053","38053","05","2","0","2387","88","2475"
"2020-04-25","AS","0","3","17","0","0","20","3","60","0","0","0","0","0"
"2020-04-25","AZ","6280","56228","0","1022","266","62508","62508","04","0","38","1559","235","1794"
"2020-04-25","CA","41137","464898","0","0","1651","506035","506035","06","89","0","9979","1883","11862"
"2020-04-25","CO","12256","44533","0","2366","674","56789","56789","08","122","129","3471","994","4465"
"2020-04-25","CT","24582","53020","0","0","1862","77602","77602","09","98","0","2903","661","3564"
"2020-04-25","DC","3699","13603","0","0","165","17302","17302","11","12","0","598","171","769"
"2020-04-25","DE","3576","14122","0","0","112","17698","17698","10","12","0","185","134","319"
"2020-04-25","FL","30839","302260","1292","5045","1075","334391","333099","12","44","157","15475","665","16140"
"2020-04-25","GA","22695","96319","0","4326","904","119014","119014","13","12","105","11290","548","11838"
"2020-04-25","GU","141","1308","0","0","5","1449","1449","66","0","0","75","0","75"
"2020-04-25","HI","601","27439","0","67","13","28040","28040","15","1","4","1148","5","1153"
"2020-04-25","IA","5092","29258","0","0","112","34350","34350","19","5","0","1730","647","2377"
"2020-04-25","ID","1870","17491","0","168","54","19361","19361","16","0","2","236","34","270"
"2020-04-25","IL","41777","159840","0","0","1874","201617","201617","17","79","0","9866","2119","11985"
"2020-04-25","IN","14395","65379","0","0","785","79774","79774","18","44","0","3506","715","4221"
"2020-04-25","KS","3056","22143","0","474","117","25199","25199","20","6","17","1332","279","1611"
"2020-04-25","KY","3779","41183","0","1143","200","44962","44962","21","9","28","1820","298","2118"
"2020-04-25","LA","26512","112490","0","0","1644","139002","139002","22","43","0","518","372","890"
"2020-04-25","MA","53348","173497","0","4965","2877","226845","226845","25","0","213","9253","2379","11632"
"2020-04-25","MD","17766","71357","0","3760","875","89123","89123","24","77","142","3257","1150","4407"
"2020-04-25","ME","990","16784","0","156","50","17774","17774","23","3","4","0","25","25"
"2020-04-25","MI","37203","106841","0","0","3274","144044","144044","26","189","0","7186","562","7748"
"2020-04-25","MN","3446","53151","0","797","244","56597","56597","27","23","41","2549","261","2810"
"2020-04-25","MO","6826","60392","0","0","273","67218","67218","29","11","0","1810","201","2011"
"2020-04-25","MP","14","51","0","0","2","65","65","69","0","0","0","0","0"
"2020-04-25","MS","5718","53239","0","996","221","58957","58957","28","12","26","3003","284","3287"
"2020-04-25","MT","445","12052","0","61","14","12497","12497","30","0","2","369","1","370"
"2020-04-25","NC","8623","96642","0","0","289","105265","105265","37","20","0","4110","571","4681"
"2020-04-25","ND","803","18547","0","70","16","19350","19350","38","1","3","1846","55","1901"
"2020-04-25","NE","2421","17552","0","0","50","19973","19973","31","3","0","1064","297","1361"
"2020-04-25","NH","1720","16007","398","224","53","18125","17727","33","2","6","868","50","918"
"2020-04-25","NJ","105523","108163","0","0","5863","213686","213686","34","246","0","4397","3327","7724"
"2020-04-25","NM","2521","48989","0","412","84","51510","51510","35","6","45","4805","142","4947"
"2020-04-25","NV","4539","32669","0","0","204","37208","37208","32","7","0","875","141","1016"
"2020-04-25","NY","282143","495425","0","61459","16599","777568","777568","36","437","1045","36359","10553","46912"
"2020-04-25","OH","15587","96396","0","3115","711","111983","111983","39","21","62","3868","418","4286"
"2020-04-25","OK","3193","49891","0","637","194","53084","53084","40","6","0","6872","72","6944"
"2020-04-25","OR","2253","45124","0","536","87","47377","47377","41","1","16","1809","76","1885"
"2020-04-25","PA","40049","152886","0","0","1537","192935","192935","42","45","0","5395","1397","6792"
"2020-04-25","PR","1307","9313","1940","0","83","12560","10620","72","6","0","0","31","31"
"2020-04-25","RI","7129","43762","0","576","215","50891","50891","44","13","0","3204","430","3634"
"2020-04-25","SC","5253","43761","0","944","166","49014","49014","45","16","107","4215","336","4551"
"2020-04-25","SD","2147","13449","0","128","10","15596","15596","46","0","4","665","107","772"
"2020-04-25","TN","9189","132217","0","821","178","141406","141406","47","10","13","9615","463","10078"
"2020-04-25","TX","23773","239043","0","0","623","262816","262816","48","30","0","19302","967","20269"
"2020-04-25","UT","3948","86258","0","329","41","90206","90206","49","2","14","5343","166","5509"
"2020-04-25","VA","12366","60276","1405","1942","436","74047","72642","51","26","105","2430","772","3202"
"2020-04-25","VI","55","693","22","0","3","770","748","78","0","0","51","1","52"
"2020-04-25","VT","843","13839","0","0","46","14682","14682","50","2","0","356","16","372"
"2020-04-25","WA","13521","161919","0","0","665","175440","175440","53","6","0","386","224","610"
"2020-04-25","WI","5687","57138","241","1376","266","63066","62825","55","4","23","2565","331","2896"
"2020-04-25","WV","1020","31946","0","0","32","32966","32966","54","0","0","3123","32","3155"
"2020-04-25","WY","349","7797","0","54","7","8146","8146","56","0","0","101","0","101"
"2020-04-24","AK","339","11942","0","0","9","12281","12281","02","0","0","118","2","120"
"2020-04-24","AL","5832","46863","0","768","197","52695","52695","01","0","0","0","54","54"
"2020-04-24","AR","2741","32837","0","291","45","35578","35578","05","0","0","3712","276","3988"
"2020-04-24","AS","0","3","17","0","0","20","3","60","0","0","0","0","0"
"2020-04-24","AZ","6045","54669","0","984","266","60714","60714","04","17","984","1741","276","2017"
"2020-04-24","CA","39254","454919","0","0","1562","494173","494173","06","93","0","10191","1885","12076"
"2020-04-24","CO","11262","41062","0","2237","552","52324","52324","08","44","114","1295","384","1679"
"2020-04-24","CT","23921","50117","0","0","1764","74038","74038","09","125","0","1720","821","2541"
"2020-04-24","DC","3528","13005","0","0","153","16533","16533","11","14","0","436","167","603"
"2020-04-24","DE","3442","13937","0","0","100","17379","17379","10","8","0","333","134","467"
"2020-04-24","FL","30174","286785","1287","4888","1031","318246","316959","12","52","195","18909","1342","20251"
"2020-04-24","GA","22147","85029","0","4221","892","107176","107176","13","20","152","5479","635","6114"
"2020-04-24","GU","141","1233","0","0","5","1374","1374","66","0","0","53","6","59"
"2020-04-24","HI","596","26291","0","63","12","26887","26887","15","0","0","755","4","759"
"2020-04-24","IA","4445","27528","0","0","107","31973","31973","19","11","0","2190","521","2711"
"2020-04-24","ID","1836","17255","0","166","54","19091","19091","16","0","4","965","34","999"
"2020-04-24","IL","39658","149974","0","0","1795","189632","189632","17","107","0","13592","2724","16316"
"2020-04-24","IN","13680","61873","0","0","741","75553","75553","18","35","0","2872","641","3513"
"2020-04-24","KS","2777","20811","0","457","111","23588","23588","20","-1","15","1975","295","2270"
"2020-04-24","KY","3481","39363","0","1115","191","42844","42844","21","6","10","6661","108","6769"
"2020-04-24","LA","26140","111972","0","0","1601","138112","138112","22","61","0","198","401","599"
"2020-04-24","MA","50969","164244","0","4752","2877","215213","215213","25","108","259","7920","2977","10897"
"2020-04-24","MD","16616","68100","0","3618","798","84716","84716","24","50","141","3737","879","4616"
"2020-04-24","ME","965","16784","0","152","47","17749","17749","23","3","2","0","28","28"
"2020-04-24","MI","36641","99655","0","0","3085","136296","136296","26","108","0","6625","1350","7975"
"2020-04-24","MN","3185","50602","0","756","221","53787","53787","27","21","44","1996","243","2239"
"2020-04-24","MO","6625","58582","0","0","262","65207","65207","29","44","0","5453","304","5757"
"2020-04-24","MP","14","51","0","0","2","65","65","69","0","0","0","0","0"
"2020-04-24","MS","5434","50236","0","970","209","55670","55670","28","8","24","0","281","281"
"2020-04-24","MT","444","11683","0","59","14","12127","12127","30","0","0","250","2","252"
"2020-04-24","NC","8052","92532","0","0","269","100584","100584","37","16","0","3955","444","4399"
"2020-04-24","ND","748","16701","0","67","15","17449","17449","38","0","2","1080","39","1119"
"2020-04-24","NE","2124","16488","0","0","47","18612","18612","31","2","0","941","311","1252"
"2020-04-24","NH","1670","15139","424","218","51","17233","16809","33","3","5","715","82","797"
"2020-04-24","NJ","102196","103766","0","0","5617","205962","205962","34","249","0","3607","2207","5814"
"2020-04-24","NM","2379","44184","0","367","78","46563","46563","35","7","36","5162","169","5331"
"2020-04-24","NV","4398","31794","0","0","197","36192","36192","32","8","0","1253","190","1443"
"2020-04-24","NY","271590","459066","0","60414","16162","730656","730656","36","422","1149","26606","8130","34736"
"2020-04-24","OH","15169","92528","0","3053","690","107697","107697","39","34","93","4345","475","4820"
"2020-04-24","OK","3121","43019","0","637","188","46140","46140","40","9","15","0","104","104"
"2020-04-24","OR","2177","43315","0","520","86","45492","45492","41","3","8","1466","50","1516"
"2020-04-24","PA","38652","147491","0","0","1492","186143","186143","42","71","0","5430","1599","7029"
"2020-04-24","PR","1276","9313","1940","0","77","12529","10589","72","8","0","0","361","361"
"2020-04-24","RI","6699","40558","0","576","202","47257","47257","44","-11","-181","2395","437","2832"
"2020-04-24","SC","4917","39546","0","837","150","44463","44463","45","0","0","0","0","0"
"2020-04-24","SD","2040","12784","0","124","10","14824","14824","46","1","5","675","84","759"
"2020-04-24","TN","8726","122602","0","808","168","131328","131328","47","-2","15","7768","460","8228"
"2020-04-24","TX","22806","219741","0","0","593","242547","242547","48","32","0","16607","862","17469"
"2020-04-24","UT","3782","80915","0","315","39","84697","84697","49","4","14","3900","170","4070"
"2020-04-24","VA","11594","57846","487","1837","410","69927","69440","51","38","84","3955","596","4551"
"2020-04-24","VI","54","642","35","0","3","731","696","78","0","0","59","0","59"
"2020-04-24","VT","827","13483","0","0","44","14310","14310","50","1","0","456","2","458"
"2020-04-24","WA","13297","161533","0","0","659","174830","174830","53","5","0","2897","302","3199"
"2020-04-24","WI","5356","54573","206","1353","262","60135","59929","55","5","35","3117","304","3421"
"2020-04-24","WV","988","28823","0","0","32","29811","29811","54","3","0","1885","21","1906"
"2020-04-24","WY","349","7696","0","54","7","8045","8045","56","0","2","455","23","478"
"2020-04-23","AK","337","11824","0","0","9","12161","12161","02","0","0","0","2","2"
"2020-04-23","AL","5778","46863","0","768","197","52641","52641","01","3","38","3568","313","3881"
"2020-04-23","AR","2465","29125","0","291","45","31590","31590","05","3","0","1688","189","1877"
"2020-04-23","AS","0","3","17","0","0","20","3","60","0","0","0","0","0"
"2020-04-23","AZ","5769","52928","0","0","249","58697","58697","04","20","0","1786","310","2096"
"2020-04-23","CA","37369","444728","0","0","1469","482097","482097","06","115","0","14797","1973","16770"
"2020-04-23","CO","10878","39767","0","2123","508","50645","50645","08","22","120","1510","431","1941"
"2020-04-23","CT","23100","48397","0","0","1639","71497","71497","09","95","0","948","631","1579"
"2020-04-23","DC","3361","12569","0","0","139","15930","15930","11","12","0","273","155","428"
"2020-04-23","DE","3308","13604","0","0","92","16912","16912","10","3","0","251","108","359"
"2020-04-23","FL","28832","267876","1301","4693","979","298009","296708","12","69","224","7558","523","8081"
"2020-04-23","GA","21512","79550","0","4069","872","101062","101062","13","36","110","6218","772","6990"
"2020-04-23","GU","135","1180","0","0","5","1315","1315","66","0","0","94","1","95"
"2020-04-23","HI","592","25536","0","63","12","26128","26128","15","0","7","776","10","786"
"2020-04-23","IA","3924","25338","0","0","96","29262","29262","19","6","0","842","176","1018"
"2020-04-23","ID","1802","16290","0","162","54","18092","18092","16","3","4","326","36","362"
"2020-04-23","IL","36934","136382","0","0","1688","173316","173316","17","123","0","7144","1826","8970"
"2020-04-23","IN","13039","59001","0","0","706","72040","72040","18","45","0","1969","601","2570"
"2020-04-23","KS","2482","18836","0","442","112","21318","21318","20","2","10","844","271","1115"
"2020-04-23","KY","3373","32702","0","1105","185","36075","36075","21","14","29","2566","181","2747"
"2020-04-23","LA","25739","111774","0","0","1540","137513","137513","22","67","0","186","481","667"
"2020-04-23","MA","47992","156324","0","4493","2769","204316","204316","25","172","237","11535","3079","14614"
"2020-04-23","MD","15737","64363","0","3477","748","80100","80100","24","50","152","2609","962","3571"
"2020-04-23","ME","937","16784","0","150","44","17721","17721","23","5","6","0","30","30"
"2020-04-23","MI","35291","93030","0","0","2977","128321","128321","26","164","0","8771","1325","10096"
"2020-04-23","MN","2942","48606","0","712","200","51548","51548","27","21","52","1983","221","2204"
"2020-04-23","MO","6321","53129","0","0","218","59450","59450","29","10","0","1110","184","1294"
"2020-04-23","MP","14","51","0","0","2","65","65","69","0","0","0","0","0"
"2020-04-23","MS","5153","50236","0","946","201","55389","55389","28","8","36","1295","259","1554"
"2020-04-23","MT","442","11433","0","59","14","11875","11875","30","0","0","289","3","292"
"2020-04-23","NC","7608","88577","0","0","253","96185","96185","37","11","0","5461","388","5849"
"2020-04-23","ND","709","15621","0","65","15","16330","16330","38","1","3","711","30","741"
"2020-04-23","NE","1813","15547","0","0","45","17360","17360","31","7","0","590","91","681"
"2020-04-23","NH","1588","14424","265","213","48","16277","16012","33","6","7","874","97","971"
"2020-04-23","NJ","99989","100159","0","0","5368","200148","200148","34","305","0","4365","4124","8489"
"2020-04-23","NM","2210","39022","0","331","71","41232","41232","35","6","25","217","138","355"
"2020-04-23","NV","4208","30541","0","0","189","34749","34749","32","17","0","734","127","861"
"2020-04-23","NY","263460","432460","0","59265","15740","695920","695920","36","438","1358","19694","6244","25938"
"2020-04-23","OH","14694","88183","0","2960","656","102877","102877","39","46","78","3794","577","4371"
"2020-04-23","OK","3017","43019","0","622","179","46036","46036","40","9","34","0","123","123"
"2020-04-23","OR","2127","41849","0","512","83","43976","43976","41","5","24","2723","68","2791"
"2020-04-23","PA","37053","142061","0","0","1421","179114","179114","42","-201","0","5789","1369","7158"
"2020-04-23","PR","915","9313","1951","0","69","12179","10228","72","2","0","471","0","471"
"2020-04-23","RI","6262","38163","0","757","213","44425","44425","44","12","40","2282","417","2699"
"2020-04-23","SC","4917","39546","0","837","150","44463","44463","45","10","0","1196","156","1352"
"2020-04-23","SD","1956","12109","0","119","9","14065","14065","46","1","8","521","98","619"
"2020-04-23","TN","8266","114834","0","793","170","123100","123100","47","4","18","7696","424","8120"
"2020-04-23","TX","21944","203134","0","0","561","225078","225078","48","18","0","7420","875","8295"
"2020-04-23","UT","3612","77015","0","301","35","80627","80627","49","1","13","4000","167","4167"
"2020-04-23","VA","10998","53891","492","1753","372","65381","64889","51","23","94","3379","732","4111"
"2020-04-23","VI","54","583","31","0","3","668","637","78","0","0","0","0","0"
"2020-04-23","VT","825","13027","0","0","43","13852","13852","50","3","0","388","2","390"
"2020-04-23","WA","12995","158636","0","0","654","171631","171631","53","7","0","3457","210","3667"
"2020-04-23","WI","5052","51456","201","1318","257","56709","56508","55","11","16","1954","207","2161"
"2020-04-23","WV","967","26938","0","0","29","27905","27905","54","3","0","2041","28","2069"
"2020-04-23","WY","326","7241","0","52","7","7567","7567","56","1","0","-60","4","-56"
"2020-04-22","AK","335","11824","0","36","9","12159","12159","02","0","0","1034","6","1040"
"2020-04-22","AL","5465","43295","0","730","194","48760","48760","01","17","31","0","234","234"
"2020-04-22","AR","2276","27437","0","291","42","29713","29713","05","-1","0","2223","49","2272"
"2020-04-22","AS","0","3","17","0","0","20","3","60","0","0","0","0","0"
"2020-04-22","AZ","5459","51142","0","0","229","56601","56601","04","21","0","1241","208","1449"
"2020-04-22","CA","35396","429931","0","0","1354","465327","465327","06","86","0","163092","2135","165227"
"2020-04-22","CO","10447","38257","0","2003","486","48704","48704","08","37","123","897","341","1238"
"2020-04-22","CT","22469","47449","0","0","1544","69918","69918","09","121","0","3617","2109","5726"
"2020-04-22","DC","3206","12296","0","0","127","15502","15502","11","15","0","455","108","563"
"2020-04-22","DE","3200","13353","0","0","89","16553","16553","10","7","0","-372","269","-103"
"2020-04-22","FL","28309","260318","1258","4469","910","289885","288627","12","54","234","10754","814","11568"
"2020-04-22","GA","20740","73332","0","3959","836","94072","94072","13","37","180","5073","859","5932"
"2020-04-22","GU","134","1086","0","0","5","1220","1220","66","0","0","53","1","54"
"2020-04-22","HI","582","24760","0","56","12","25342","25342","15","2","1","648","-2","646"
"2020-04-22","IA","3748","24496","0","0","90","28244","28244","19","7","0","522","107","629"
"2020-04-22","ID","1766","15964","0","158","51","17730","17730","16","3","1","40","30","70"
"2020-04-22","IL","35108","129238","0","0","1565","164346","164346","17","97","0","7300","2049","9349"
"2020-04-22","IN","12438","57032","0","0","661","69470","69470","18","31","0","1865","341","2206"
"2020-04-22","KS","2211","17992","0","432","110","20203","20203","20","3","13","916","186","1102"
"2020-04-22","KY","3192","30136","0","1076","171","33328","33328","21","17","17","366","142","508"
"2020-04-22","LA","25258","111588","0","0","1473","136846","136846","22","68","0","0","404","404"
"2020-04-22","MA","44913","144789","0","4256","2597","189702","189702","25","148","247","3345","1745","5090"
"2020-04-22","MD","14775","61754","0","3325","698","76529","76529","24","46","167","2312","582","2894"
"2020-04-22","ME","907","16784","0","144","39","17691","17691","23","3","5","2708","19","2727"
"2020-04-22","MI","33966","84259","0","0","2813","118225","118225","26","113","0","0","999","999"
"2020-04-22","MN","2721","46623","0","660","179","49344","49344","27","19","31","1493","154","1647"
"2020-04-22","MO","6137","52019","0","0","208","58156","58156","29","19","0","840","196","1036"
"2020-04-22","MP","14","51","0","0","2","65","65","69","0","0","0","0","0"
"2020-04-22","MS","4894","48941","0","910","193","53835","53835","28","10","52","1293","178","1471"
"2020-04-22","MT","439","11144","0","59","14","11583","11583","30","2","0","340","2","342"
"2020-04-22","NC","7220","83116","0","0","242","90336","90336","37","29","0","6736","269","7005"
"2020-04-22","ND","679","14910","0","62","14","15589","15589","38","1","8","567","35","602"
"2020-04-22","NE","1722","14957","0","0","38","16679","16679","31","5","0","233","74","307"
"2020-04-22","NH","1491","13550","225","206","42","15266","15041","33","0","0","702","0","702"
"2020-04-22","NJ","95865","95794","0","0","5063","191659","191659","34","310","0","3355","3478","6833"
"2020-04-22","NM","2072","38805","0","306","65","40877","40877","35","7","15","2021","101","2122"
"2020-04-22","NV","4081","29807","0","0","172","33888","33888","32","9","0","689","144","833"
"2020-04-22","NY","257216","412766","0","57907","15302","669982","669982","36","474","1381","15131","5526","20657"
"2020-04-22","OH","14117","84389","0","2882","610","98506","98506","39","53","103","3400","392","3792"
"2020-04-22","OK","2894","43019","0","588","170","45913","45913","40","6","27","1482","87","1569"
"2020-04-22","OR","2059","39126","0","488","78","41185","41185","41","0","17","0","57","57"
"2020-04-22","PA","35684","136272","0","0","1622","171956","171956","42","58","0","3949","1156","5105"
"2020-04-22","PR","915","8842","1954","0","67","11711","9757","72","3","0","53","-383","-330"
"2020-04-22","RI","5845","35881","0","717","201","41726","41726","44","15","43","2048","378","2426"
"2020-04-22","SC","4761","38350","0","837","140","43111","43111","45","16","61","1512","322","1834"
"2020-04-22","SD","1858","11588","0","111","8","13446","13446","46","0","11","528","103","631"
"2020-04-22","TN","7842","107138","0","775","166","114980","114980","47","9","15","6350","448","6798"
"2020-04-22","TX","21069","195714","0","0","543","216783","216783","48","26","0","10511","873","11384"
"2020-04-22","UT","3445","73015","0","288","34","76460","76460","49","2","11","3953","149","4102"
"2020-04-22","VA","10266","50512","477","1659","349","61255","60778","51","25","78","1788","636","2424"
"2020-04-22","VI","54","583","31","0","3","668","637","78","0","0","9","0","9"
"2020-04-22","VT","823","12639","0","0","40","13462","13462","50","0","0","346","5","351"
"2020-04-22","WA","12785","155179","0","0","647","167964","167964","53","7","0","4162","235","4397"
"2020-04-22","WI","4845","49502","229","1302","246","54576","54347","55","4","50","1661","225","1886"
"2020-04-22","WV","939","24897","0","0","26","25836","25836","54","0","0","3048","25","3073"
"2020-04-22","WY","322","7301","0","52","6","7623","7623","56","0","0","0","2","2"
"2020-04-21","AK","329","10790","0","36","9","11119","11119","02","0","0","987","8","995"
"2020-04-21","AL","5231","43295","0","699","177","48526","48526","01","10","58","2420","206","2626"
"2020-04-21","AR","2227","25214","0","291","43","27441","27441","05","1","0","584","304","888"
"2020-04-21","AS","0","3","17","0","0","20","3","60","0","0","0","0","0"
"2020-04-21","AZ","5251","49901","0","0","208","55152","55152","04","21","0","465","187","652"
"2020-04-21","CA","33261","266839","0","0","1268","300100","300100","06","60","0","7317","2283","9600"
"2020-04-21","CO","10106","37360","0","1880","449","47466","47466","08","27","67","895","376","1271"
"2020-04-21","CT","20360","43832","0","0","1423","64192","64192","09","92","0","841","545","1386"
"2020-04-21","DC","3098","11841","0","0","112","14939","14939","11","7","0","655","171","826"
"2020-04-21","DE","2931","13725","0","0","82","16656","16656","10","10","0","0","186","186"
"2020-04-21","FL","27495","249564","1203","4235","856","278262","277059","12","50","225","9999","835","10834"
"2020-04-21","GA","19881","68259","0","3779","799","88140","88140","13","66","229","2878","934","3812"
"2020-04-21","GU","133","1033","0","0","5","1166","1166","66","0","0","42","0","42"
"2020-04-21","HI","584","24112","0","55","10","24696","24696","15","0","3","517","4","521"
"2020-04-21","IA","3641","23974","0","0","83","27615","27615","19","4","0","1313","482","1795"
"2020-04-21","ID","1736","15924","0","157","48","17660","17660","16","3","6","151","64","215"
"2020-04-21","IL","33059","121938","0","0","1468","154997","154997","17","119","0","5088","1551","6639"
"2020-04-21","IN","12097","55167","0","0","630","67264","67264","18","61","0","2214","411","2625"
"2020-04-21","KS","2025","17076","0","419","107","19101","19101","20","7","14","301","39","340"
"2020-04-21","KY","3050","29770","0","1059","154","32820","32820","21","6","0","158","90","248"
"2020-04-21","LA","24854","111588","0","0","1405","136442","136442","22","77","0","0","331","331"
"2020-04-21","MA","43168","141444","0","4009","2449","184612","184612","25","146","137","5398","1752","7150"
"2020-04-21","MD","14193","59442","0","3158","652","73635","73635","24","70","144","1729","509","2238"
"2020-04-21","ME","888","14076","0","139","36","14964","14964","23","1","1","0","13","13"
"2020-04-21","MI","32967","84259","0","0","2700","117226","117226","26","232","0","2461","967","3428"
"2020-04-21","MN","2567","45130","0","629","160","47697","47697","27","17","27","750","97","847"
"2020-04-21","MO","5941","51179","0","0","189","57120","57120","29","12","0","973","134","1107"
"2020-04-21","MP","14","51","0","0","2","65","65","69","0","0","0","0","0"
"2020-04-21","MS","4716","47648","0","858","183","52364","52364","28","14","39","726","204","930"
"2020-04-21","MT","437","10804","0","59","12","11241","11241","30","2","2","186","4","190"
"2020-04-21","NC","6951","76380","0","0","213","83331","83331","37","34","0","3660","187","3847"
"2020-04-21","ND","644","14343","0","54","13","14987","14987","38","0","1","223","17","240"
"2020-04-21","NE","1648","14724","0","0","33","16372","16372","31","5","0","518","174","692"
"2020-04-21","NH","1491","12848","244","206","42","14583","14339","33","1","8","122","99","221"
"2020-04-21","NJ","92387","92439","0","0","4753","184826","184826","34","376","0","3188","3581","6769"
"2020-04-21","NM","1971","36784","0","291","58","38755","38755","35","3","17","1587","126","1713"
"2020-04-21","NV","3937","29118","0","0","163","33055","33055","32","5","0","601","107","708"
"2020-04-21","NY","251690","397635","0","56526","14828","649325","649325","36","481","1338","11286","4178","15464"
"2020-04-21","OH","13725","80989","0","2779","557","94714","94714","39","48","126","3069","806","3875"
"2020-04-21","OK","2807","41537","0","561","164","44344","44344","40","21","20","8571","127","8698"
"2020-04-21","OR","2002","39126","0","471","78","41128","41128","41","3","6","1037","46","1083"
"2020-04-21","PA","34528","132323","0","0","1564","166851","166851","42","360","0","2603","1296","3899"
"2020-04-21","PR","1298","8789","1761","0","64","11848","10087","72","1","0","303","46","349"
"2020-04-21","RI","5467","33833","0","674","186","39300","39300","44","11","45","1843","369","2212"
"2020-04-21","SC","4439","36838","0","776","124","41277","41277","45","4","0","735","62","797"
"2020-04-21","SD","1755","11060","0","100","8","12815","12815","46","1","13","419","70","489"
"2020-04-21","TN","7394","100788","0","760","157","108182","108182","47","5","30","7337","156","7493"
"2020-04-21","TX","20196","185203","0","0","517","205399","205399","48","22","0","14267","738","15005"
"2020-04-21","UT","3296","69062","0","277","32","72358","72358","49","4","9","3964","83","4047"
"2020-04-21","VA","9630","48724","477","1581","324","58831","58354","51","24","81","979","640","1619"
"2020-04-21","VI","54","574","35","0","3","663","628","78","0","0","20","1","21"
"2020-04-21","VT","818","12293","0","0","40","13111","13111","50","2","0","128","2","130"
"2020-04-21","WA","12550","151017","0","0","640","163567","163567","53","11","0","4598","204","4802"
"2020-04-21","WI","4620","47841","219","1252","242","52680","52461","55","12","41","1238","121","1359"
"2020-04-21","WV","914","21849","0","0","26","22763","22763","54","2","0","596","12","608"
"2020-04-21","WY","320","7301","0","52","6","7621","7621","56","4","1","228","7","235"
"2020-04-20","AK","321","9803","0","36","9","10124","10124","02","0","0","227","2","229"
"2020-04-20","AL","5025","40875","0","641","167","45900","45900","01","13","0","0","188","188"
"2020-04-20","AR","1923","24630","0","291","42","26553","26553","05","2","0","2202","142","2344"
"2020-04-20","AS","0","3","17","0","0","20","3","60","0","0","0","0","0"
"2020-04-20","AZ","5064","49436","0","0","187","54500","54500","04","3","0","1375","135","1510"
"2020-04-20","CA","30978","259522","0","0","1208","290500","290500","06","42","0","8955","645","9600"
"2020-04-20","CO","9730","36465","0","1813","422","46195","46195","08","11","16","1292","297","1589"
"2020-04-20","CT","19815","42991","0","0","1331","62806","62806","09","245","0","2328","2265","4593"
"2020-04-20","DC","2927","11186","0","0","105","14113","14113","11","9","0","280","134","414"
"2020-04-20","DE","2745","13725","0","0","72","16470","16470","10","5","0","1469","207","1676"
"2020-04-20","FL","26660","239565","1104","4010","806","267329","266225","12","25","80","9482","664","10146"
"2020-04-20","GA","18947","65381","0","3550","733","84328","84328","13","46","86","3749","646","4395"
"2020-04-20","GU","133","991","0","0","5","1124","1124","66","0","0","48","0","48"
"2020-04-20","HI","580","23595","0","52","10","24175","24175","15","1","1","699","6","705"
"2020-04-20","IA","3159","22661","0","0","79","25820","25820","19","4","0","1013","257","1270"
"2020-04-20","ID","1672","15773","0","151","45","17445","17445","16","1","0","572","4","576"
"2020-04-20","IL","31508","116850","0","0","1349","148358","148358","17","59","0","3889","1151","5040"
"2020-04-20","IN","11686","52953","0","0","569","64639","64639","18","7","0","3021","476","3497"
"2020-04-20","KS","1986","16775","0","405","100","18761","18761","20","8","15","494","137","631"
"2020-04-20","KY","2960","29612","0","1059","148","32572","32572","21","4","0","94","253","347"
"2020-04-20","LA","24523","111588","0","0","1328","136111","136111","22","32","0","168","595","763"
"2020-04-20","MA","41416","136046","0","3872","2303","177462","177462","25","157","83","6751","1596","8347"
"2020-04-20","MD","13684","57713","0","3014","582","71397","71397","24","34","128","2652","854","3506"
"2020-04-20","ME","875","14076","0","138","35","14951","14951","23","1","2","0","8","8"
"2020-04-20","MI","32000","81798","0","0","2468","113798","113798","26","77","0","3561","576","4137"
"2020-04-20","MN","2470","44380","0","602","143","46850","46850","27","9","28","1020","114","1134"
"2020-04-20","MO","5807","50206","0","0","177","56013","56013","29","1","0","1964","140","2104"
"2020-04-20","MP","14","51","0","0","2","65","65","69","0","0","9","0","9"
"2020-04-20","MS","4512","46922","0","819","169","51434","51434","28","10","11","12131","238","12369"
"2020-04-20","MT","433","10618","0","57","10","11051","11051","30","0","2","153","0","153"
"2020-04-20","NC","6764","72720","0","0","179","79484","79484","37","7","0","441","271","712"
"2020-04-20","ND","627","14120","0","53","13","14747","14747","38","3","2","1075","42","1117"
"2020-04-20","NE","1474","14206","0","0","28","15680","15680","31","0","0","918","187","1105"
"2020-04-20","NH","1392","12726","298","198","41","14416","14118","33","3","6","644","50","694"
"2020-04-20","NJ","88806","89251","0","0","4377","178057","178057","34","175","0","3864","3505","7369"
"2020-04-20","NM","1845","35197","0","274","55","37042","37042","35","2","16","363","47","410"
"2020-04-20","NV","3830","28517","0","0","158","32347","32347","32","3","0","647","102","749"
"2020-04-20","NY","247512","386349","0","55188","14347","633861","633861","36","478","1379","11580","4726","16306"
"2020-04-20","OH","12919","77920","0","2653","509","90839","90839","39","38","88","2223","1317","3540"
"2020-04-20","OK","2680","32966","0","541","143","35646","35646","40","3","0","0","81","81"
"2020-04-20","OR","1956","38089","0","465","75","40045","40045","41","1","9","961","46","1007"
"2020-04-20","PA","33232","129720","0","0","1204","162952","162952","42","92","0","3150","948","4098"
"2020-04-20","PR","1252","8486","1895","0","63","11633","9738","72","1","0","206","39","245"
"2020-04-20","RI","5098","31990","0","629","175","37088","37088","44","11","24","1997","343","2340"
"2020-04-20","SC","4377","36103","0","776","120","40480","40480","45","0","0","0","0","0"
"2020-04-20","SD","1685","10641","0","87","7","12326","12326","46","0","13","214","50","264"
"2020-04-20","TN","7238","93451","0","730","152","100689","100689","47","4","6","3423","168","3591"
"2020-04-20","TX","19458","170936","0","0","495","190394","190394","48","18","0","7149","535","7684"
"2020-04-20","UT","3213","65098","0","268","28","68311","68311","49","1","9","4612","144","4756"
"2020-04-20","VA","8990","47745","468","1500","300","57203","56735","51","23","78","1549","453","2002"
"2020-04-20","VI","53","554","18","0","3","625","607","78","0","0","6","0","6"
"2020-04-20","VT","816","12165","0","0","38","12981","12981","50","0","0","251","4","255"
"2020-04-20","WA","12346","146419","0","0","629","158765","158765","53","14","0","4211","200","4411"
"2020-04-20","WI","4499","46603","237","1211","230","51339","51102","55","10","21","1280","153","1433"
"2020-04-20","WV","902","21253","0","0","24","22155","22155","54","6","0","2085","39","2124"
"2020-04-20","WY","313","7073","0","51","2","7386","7386","56","0","1","101","4","105"
"2020-04-19","AK","319","9576","0","36","9","9895","9895","02","0","0","235","5","240"
"2020-04-19","AL","4837","40875","0","641","154","45712","45712","01","8","21","2992","182","3174"
"2020-04-19","AR","1781","22428","0","291","40","24209","24209","05","2","0","26","42","68"
"2020-04-19","AS","0","3","17","0","0","20","3","60","0","0","0","0","0"
"2020-04-19","AZ","4929","48061","0","0","184","52990","52990","04","7","0","1735","210","1945"
"2020-04-19","CA","30333","250567","7200","0","1166","288100","280900","06","94","0","19864","1370","21234"
"2020-04-19","CO","9433","35173","0","1797","411","44606","44606","08","20","42","913","386","1299"
"2020-04-19","CT","17550","40663","0","0","1086","58213","58213","09","50","0","2010","741","2751"
"2020-04-19","DC","2793","10906","0","0","96","13699","13699","11","5","0","304","127","431"
"2020-04-19","DE","2538","12256","0","0","67","14794","14794","10","6","0","562","215","777"
"2020-04-19","FL","25996","230083","1179","3930","781","257258","256079","12","27","88","8825","727","9552"
"2020-04-19","GA","18301","61632","0","3464","687","79933","79933","13","14","44","5093","632","5725"
"2020-04-19","GU","133","943","0","0","5","1076","1076","66","0","0","0","0","0"
"2020-04-19","HI","574","22896","0","51","9","23470","23470","15","0","3","1106","21","1127"
"2020-04-19","IA","2902","21648","0","0","75","24550","24550","19","1","0","1214","389","1603"
"2020-04-19","ID","1668","15201","0","151","44","16869","16869","16","1","0","247","13","260"
"2020-04-19","IL","30357","112961","0","0","1290","143318","143318","17","31","0","4717","1197","5914"
"2020-04-19","IN","11210","49932","0","0","562","61142","61142","18","17","0","3700","569","4269"
"2020-04-19","KS","1849","16281","0","390","92","18130","18130","20","6","7","395","59","454"
"2020-04-19","KY","2707","29518","0","1059","144","32225","32225","21","7","51","1444","185","1629"
"2020-04-19","LA","23928","111420","0","0","1296","135348","135348","22","29","0","-2999","348","-2651"
"2020-04-19","MA","39820","129295","0","3789","2146","169115","169115","25","163","61","4691","2293","6984"
"2020-04-19","MD","12830","55061","0","2886","548","67891","67891","24","14","129","1999","522","2521"
"2020-04-19","ME","867","14076","0","136","34","14943","14943","23","2","0","0","20","20"
"2020-04-19","MI","31424","78237","0","0","2391","109661","109661","26","83","0","9301","633","9934"
"2020-04-19","MN","2356","43360","0","574","134","45716","45716","27","13","13","1305","143","1448"
"2020-04-19","MO","5667","48242","0","0","176","53909","53909","29","1","0","0","150","150"
"2020-04-19","MP","14","42","4","0","2","60","56","69","0","0","0","0","0"
"2020-04-19","MS","4274","34791","0","808","159","39065","39065","28","7","26","0","300","300"
"2020-04-19","MT","433","10465","0","55","10","10898","10898","30","0","0","322","7","329"
"2020-04-19","NC","6493","72279","0","0","172","78772","78772","37","8","0","2208","353","2561"
"2020-04-19","ND","585","13045","0","51","10","13630","13630","38","1","4","610","57","667"
"2020-04-19","NE","1287","13288","0","0","28","14575","14575","31","4","0","749","149","898"
"2020-04-19","NH","1342","12082","316","192","38","13740","13424","33","1","2","517","55","572"
"2020-04-19","NJ","85301","85387","0","0","4202","170688","170688","34","132","0","4271","3881","8152"
"2020-04-19","NM","1798","34834","0","258","53","36632","36632","35","2","16","932","87","1019"
"2020-04-19","NV","3728","27870","0","0","155","31598","31598","32","4","0","745","102","847"
"2020-04-19","NY","242786","374769","0","53809","13869","617555","617555","36","507","1384","14969","6054","21023"
"2020-04-19","OH","11602","75697","0","2565","471","87299","87299","39","20","46","6878","1380","8258"
"2020-04-19","OK","2599","32966","0","541","140","35565","35565","40","1","0","0","29","29"
"2020-04-19","OR","1910","37128","0","456","74","39038","39038","41","2","7","1389","66","1455"
"2020-04-19","PA","32284","126570","0","0","1112","158854","158854","42","276","0","3674","1215","4889"
"2020-04-19","PR","1213","8280","1839","0","62","11332","9493","72","2","0","225","95","320"
"2020-04-19","RI","4755","29993","0","605","164","34748","34748","44","14","27","1658","276","1934"
"2020-04-19","SC","4377","36103","0","776","120","40480","40480","45","1","0","1516","131","1647"
"2020-04-19","SD","1635","10427","0","74","7","12062","12062","46","0","6","309","93","402"
"2020-04-19","TN","7070","90028","0","724","148","97098","97098","47","3","5","6204","308","6512"
"2020-04-19","TX","18923","163787","0","0","477","182710","182710","48","24","0","5808","663","6471"
"2020-04-19","UT","3069","60486","0","259","27","63555","63555","49","2","8","3473","138","3611"
"2020-04-19","VA","8537","46196","499","1422","277","55232","54733","51","19","126","2318","484","2802"
"2020-04-19","VI","53","548","22","0","3","623","601","78","0","0","158","0","158"
"2020-04-19","VT","812","11914","0","0","38","12726","12726","50","0","0","151","9","160"
"2020-04-19","WA","12146","142208","0","0","615","154354","154354","53","17","0","1399","259","1658"
"2020-04-19","WI","4346","45323","248","1190","220","49917","49669","55","9","14","1361","147","1508"
"2020-04-19","WV","863","19168","0","0","18","20031","20031","54","2","0","513","78","591"
"2020-04-19","WY","309","6972","0","50","2","7281","7281","56","0","0","755","4","759"
"2020-04-18","AK","314","9341","0","36","9","9655","9655","02","0","0","200","5","205"
"2020-04-18","AL","4655","37883","0","620","146","42538","42538","01","2","26","4565","125","4690"
"2020-04-18","AR","1739","22402","0","291","38","24141","24141","05","1","291","603","44","647"
"2020-04-18","AS","0","3","17","0","0","20","3","60","0","0","0","0","0"
"2020-04-18","AZ","4719","46326","0","0","177","51045","51045","04","8","0","1603","212","1815"
"2020-04-18","CA","28963","230703","7200","0","1072","266866","259666","06","87","0","6617","1435","8052"
"2020-04-18","CO","9047","34260","0","1755","391","43307","43307","08","17","62","1105","372","1477"
"2020-04-18","CT","16809","38653","0","0","1036","55462","55462","09","0","0","0","0","0"
"2020-04-18","DC","2666","10602","0","0","91","13268","13268","11","5","0","435","190","625"
"2020-04-18","DE","2323","11694","0","0","61","14017","14017","10","0","0","0","0","0"
"2020-04-18","FL","25269","221258","0","3842","754","246527","246527","12","55","177","10540","1150","11690"
"2020-04-18","GA","17669","56539","0","3420","673","74208","74208","13","23","96","2049","475","2524"
"2020-04-18","GU","133","943","0","0","5","1076","1076","66","0","0","3","0","3"
"2020-04-18","HI","553","21790","0","48","9","22343","22343","15","0","3","474","12","486"
"2020-04-18","IA","2513","20434","0","0","74","22947","22947","19","10","0","974","181","1155"
"2020-04-18","ID","1655","14954","0","151","43","16609","16609","16","2","3","380","46","426"
"2020-04-18","IL","29160","108244","0","0","1259","137404","137404","17","125","0","5656","1585","7241"
"2020-04-18","IN","10641","46232","0","0","545","56873","56873","18","26","0","1601","487","2088"
"2020-04-18","KS","1790","15886","0","383","86","17676","17676","20","2","8","690","85","775"
"2020-04-18","KY","2522","28074","0","1008","137","30596","30596","21","8","37","756","93","849"
"2020-04-18","LA","23580","114419","0","0","1267","137999","137999","22","54","0","5550","462","6012"
"2020-04-18","MA","37527","124604","0","3728","1983","162131","162131","25","161","-28","7409","2402","9811"
"2020-04-18","MD","12308","53062","0","2757","534","65370","65370","24","40","145","2625","736","3361"
"2020-04-18","ME","847","14076","0","136","32","14923","14923","23","3","3","0","20","20"
"2020-04-18","MI","30791","68936","0","0","2308","99727","99727","26","81","0","0","768","768"
"2020-04-18","MN","2213","42055","0","561","121","44268","44268","27","10","43","1073","142","1215"
"2020-04-18","MO","5517","48242","0","0","175","53759","53759","29","10","0","1808","234","2042"
"2020-04-18","MP","14","42","4","0","2","60","56","69","0","0","0","1","1"
"2020-04-18","MS","3974","34791","0","782","152","38765","38765","28","12","46","0","181","181"
"2020-04-18","MT","426","10143","0","55","10","10569","10569","30","2","1","321","4","325"
"2020-04-18","NC","6140","70071","0","0","164","76211","76211","37","12","0","2949","281","3230"
"2020-04-18","ND","528","12435","0","47","9","12963","12963","38","0","0","532","89","621"
"2020-04-18","NE","1138","12539","0","0","24","13677","13677","31","0","0","501","72","573"
"2020-04-18","NH","1287","11565","174","190","37","13026","12852","33","0","0","144","0","144"
"2020-04-18","NJ","81420","81116","0","0","4070","162536","162536","34","230","0","2134","2953","5087"
"2020-04-18","NM","1711","33902","0","242","51","35613","35613","35","7","12","1011","114","1125"
"2020-04-18","NV","3626","27125","0","0","151","30751","30751","32","9","0","887","102","989"
"2020-04-18","NY","236732","359800","0","52425","13362","596532","596532","36","540","1917","16219","7090","23309"
"2020-04-18","OH","10222","68819","0","2519","451","79041","79041","39","33","95","0","1115","1115"
"2020-04-18","OK","2570","32966","0","541","139","35536","35536","40","3","13","1811","105","1916"
"2020-04-18","OR","1844","35739","0","449","72","37583","37583","41","2","22","1203","59","1262"
"2020-04-18","PA","31069","122896","0","0","836","153965","153965","42","80","0","4964","1628","6592"
"2020-04-18","PR","1118","8055","1760","0","60","10933","9173","72","2","0","191","50","241"
"2020-04-18","RI","4479","28335","0","578","150","32814","32814","44","32","247","1751","302","2053"
"2020-04-18","SC","4246","34587","0","776","119","38833","38833","45","10","101","2234","315","2549"
"2020-04-18","SD","1542","10118","1","68","7","11661","11660","46","0","5","467","131","598"
"2020-04-18","TN","6762","83824","0","719","145","90586","90586","47","3","8","3140","173","3313"
"2020-04-18","TX","18260","157979","0","0","453","176239","176239","48","25","0","5814","889","6703"
"2020-04-18","UT","2931","57013","0","251","25","59944","59944","49","2","7","4047","126","4173"
"2020-04-18","VA","8053","43878","486","1296","258","52417","51931","51","27","75","2372","562","2934"
"2020-04-18","VI","53","390","35","0","3","478","443","78","1","0","17","2","19"
"2020-04-18","VT","803","11763","0","0","38","12566","12566","50","3","0","426","24","450"
"2020-04-18","WA","11887","140809","0","0","598","152696","152696","53","13","0","2038","214","2252"
"2020-04-18","WI","4199","43962","229","1176","211","48390","48161","55","6","23","1597","154","1751"
"2020-04-18","WV","785","18655","0","0","16","19440","19440","54","3","0","728","31","759"
"2020-04-18","WY","305","6217","0","50","2","6522","6522","56","0","7","86","9","95"
"2020-04-17","AK","309","9141","0","36","9","9450","9450","02","0","1","706","9","715"
"2020-04-17","AL","4530","33318","0","594","144","37848","37848","01","11","41","1272","185","1457"
"2020-04-17","AR","1695","21799","0","0","37","23494","23494","05","0","0","744","75","819"
"2020-04-17","AS","0","3","17","0","0","20","3","60","0","0","0","0","0"
"2020-04-17","AZ","4507","44723","0","0","169","49230","49230","04","19","0","1559","273","1832"
"2020-04-17","CA","27528","224086","7200","0","985","258814","251614","06","95","0","3868","1346","5214"
"2020-04-17","CO","8675","33155","0","1693","374","41830","41830","08","17","57","902","395","1297"
"2020-04-17","CT","16809","38653","0","0","1036","55462","55462","09","65","0","1415","925","2340"
"2020-04-17","DC","2476","10167","0","0","86","12643","12643","11","5","0","367","126","493"
"2020-04-17","DE","2323","11694","0","0","61","14017","14017","10","9","0","419","248","667"
"2020-04-17","FL","24119","210718","1285","3665","699","236122","234837","12","53","205","14367","1222","15589"
"2020-04-17","GA","17194","54490","0","3324","650","71684","71684","13","63","216","2220","1525","3745"
"2020-04-17","GU","133","940","0","0","5","1073","1073","66","0","0","70","0","70"
"2020-04-17","HI","541","21316","0","45","9","21857","21857","15","0","0","1146","11","1157"
"2020-04-17","IA","2332","19460","0","0","64","21792","21792","19","4","0","926","191","1117"
"2020-04-17","ID","1609","14574","0","148","41","16183","16183","16","0","5","330","22","352"
"2020-04-17","IL","27575","102588","0","0","1134","130163","130163","17","62","0","5732","1842","7574"
"2020-04-17","IN","10154","44631","0","0","519","54785","54785","18","42","0","3058","612","3670"
"2020-04-17","KS","1705","15196","0","375","84","16901","16901","20","4","16","662","117","779"
"2020-04-17","KY","2429","27318","0","971","129","29747","29747","21","7","164","1285","138","1423"
"2020-04-17","LA","23118","108869","0","0","1213","131987","131987","22","57","0","4815","586","5401"
"2020-04-17","MA","35125","117195","0","3756","1822","152320","152320","25","155","30","7097","2633","9730"
"2020-04-17","MD","11572","50437","0","2612","494","62009","62009","24","35","161","2378","788","3166"
"2020-04-17","ME","827","14076","0","133","29","14903","14903","23","2","3","0","31","31"
"2020-04-17","MI","30023","68936","0","0","2227","98959","98959","26","134","0","3913","760","4673"
"2020-04-17","MN","2071","40982","0","518","111","43053","43053","27","17","43","1219","159","1378"
"2020-04-17","MO","5283","46434","0","0","165","51717","51717","29","13","0","897","172","1069"
"2020-04-17","MP","13","42","4","0","2","59","55","69","0","0","15","0","15"
"2020-04-17","MS","3793","34791","0","736","140","38584","38584","28","11","54","0","169","169"
"2020-04-17","MT","422","9822","0","54","8","10244","10244","30","1","2","301","7","308"
"2020-04-17","NC","5859","67122","0","0","152","72981","72981","37","21","0","1670","394","2064"
"2020-04-17","ND","439","11903","0","47","9","12342","12342","38","0","2","592","46","638"
"2020-04-17","NE","1066","12038","0","0","24","13104","13104","31","3","0","696","114","810"
"2020-04-17","NH","1287","11421","174","190","37","12882","12708","33","5","12","394","148","542"
"2020-04-17","NJ","78467","78982","0","0","3840","157449","157449","34","322","0","2469","3150","5619"
"2020-04-17","NM","1597","32891","0","230","44","34488","34488","35","8","15","981","113","1094"
"2020-04-17","NV","3524","26238","0","0","142","29762","29762","32","5","0","1108","203","1311"
"2020-04-17","NY","229642","343581","0","50508","12822","573223","573223","36","630","1973","15286","7358","22644"
"2020-04-17","OH","9107","68819","0","2424","418","77926","77926","39","29","93","2393","693","3086"
"2020-04-17","OK","2465","31155","0","528","136","33620","33620","40","5","0","2613","108","2721"
"2020-04-17","OR","1785","34536","0","427","70","36321","36321","41","6","13","1334","49","1383"
"2020-04-17","PA","29441","117932","0","0","756","147373","147373","42","49","0","4197","1706","5903"
"2020-04-17","PR","1068","7864","1478","0","58","10410","8932","72","2","0","549","25","574"
"2020-04-17","RI","4177","26584","0","331","118","30761","30761","44","13","0","2358","339","2697"
"2020-04-17","SC","3931","32353","0","675","109","36284","36284","45","2","0","1276","275","1551"
"2020-04-17","SD","1411","9651","0","63","7","11062","11062","46","0","8","412","100","512"
"2020-04-17","TN","6589","80684","0","711","142","87273","87273","47","1","20","1897","327","2224"
"2020-04-17","TX","17371","152165","0","0","428","169536","169536","48","35","0","10073","916","10989"
"2020-04-17","UT","2805","52966","0","244","23","55771","55771","49","2","6","5971","122","6093"
"2020-04-17","VA","7491","41506","499","1221","231","49496","48997","51","23","107","1951","602","2553"
"2020-04-17","VI","51","373","34","0","2","458","424","78","1","0","16","0","16"
"2020-04-17","VT","779","11337","0","0","35","12116","12116","50","0","0","598","11","609"
"2020-04-17","WA","11673","138771","0","0","585","150444","150444","53","14","0","4020","330","4350"
"2020-04-17","WI","4045","42365","198","1153","205","46608","46410","55","8","32","1391","170","1561"
"2020-04-17","WV","754","17927","0","0","13","18681","18681","54","0","0","360","15","375"
"2020-04-17","WY","296","6131","0","43","2","6427","6427","56","0","0","0","0","0"
"2020-04-16","AK","300","8435","0","35","9","8735","8735","02","0","1","64","7","71"
"2020-04-16","AL","4345","32046","0","553","133","36391","36391","01","12","28","2082","232","2314"
"2020-04-16","AR","1620","21055","0","0","37","22675","22675","05","4","0","790","51","841"
"2020-04-16","AS","0","3","17","0","0","20","3","60","0","0","0","0","0"
"2020-04-16","AZ","4234","43164","0","0","150","47398","47398","04","8","0","1816","272","2088"
"2020-04-16","CA","26182","220218","13200","0","890","259600","246400","06","69","0","28156","1758","29914"
"2020-04-16","CO","8280","32253","0","1636","357","40533","40533","08","28","80","614","339","953"
"2020-04-16","CT","15884","37238","0","0","971","53122","53122","09","103","0","1850","1129","2979"
"2020-04-16","DC","2350","9800","0","0","81","12150","12150","11","9","0","472","153","625"
"2020-04-16","DE","2075","11275","0","0","52","13350","13350","10","6","0","187","61","248"
"2020-04-16","FL","22897","196351","1325","3460","646","220573","219248","12","37","116","5353","386","5739"
"2020-04-16","GA","15669","52270","0","3108","587","67939","67939","13","35","186","3167","682","3849"
"2020-04-16","GU","133","870","0","0","5","1003","1003","66","0","0","27","0","27"
"2020-04-16","HI","530","20170","0","45","9","20700","20700","15","0","0","884","13","897"
"2020-04-16","IA","2141","18534","0","0","60","20675","20675","19","7","0","660","146","806"
"2020-04-16","ID","1587","14244","0","143","41","15831","15831","16","2","2","310","123","433"
"2020-04-16","IL","25733","96856","0","0","1072","122589","122589","17","124","0","4520","1140","5660"
"2020-04-16","IN","9542","41573","0","0","477","51115","51115","18","41","0","2132","587","2719"
"2020-04-16","KS","1588","14534","0","359","80","16122","16122","20","4","17","1360","94","1454"
"2020-04-16","KY","2291","26033","0","807","122","28324","28324","21","7","120","546","81","627"
"2020-04-16","LA","22532","104054","0","0","1156","126586","126586","22","53","0","4077","581","4658"
"2020-04-16","MA","32492","110098","0","3726","1667","142590","142590","25","165","89","7308","2522","9830"
"2020-04-16","MD","10784","48059","0","2451","459","58843","58843","24","46","220","2328","752","3080"
"2020-04-16","ME","796","14076","0","130","27","14872","14872","23","3","4","0","26","26"
"2020-04-16","MI","29263","65023","0","0","2093","94286","94286","26","172","0","3385","1204","4589"
"2020-04-16","MN","1912","39763","0","475","94","41675","41675","27","7","30","1330","103","1433"
"2020-04-16","MO","5111","45537","0","0","152","50648","50648","29","5","0","1420","216","1636"
"2020-04-16","MP","13","27","7","0","2","47","40","69","0","0","0","0","0"
"2020-04-16","MS","3624","34791","0","682","129","38415","38415","28","7","37","0","264","264"
"2020-04-16","MT","415","9521","0","52","7","9936","9936","30","0","1","342","11","353"
"2020-04-16","NC","5465","65452","0","0","131","70917","70917","37","14","0","2748","342","3090"
"2020-04-16","ND","393","11311","0","45","9","11704","11704","38","0","1","359","28","387"
"2020-04-16","NE","952","11342","0","0","21","12294","12294","31","1","0","514","51","565"
"2020-04-16","NH","1139","11027","121","178","32","12287","12166","33","0","0","0","0","0"
"2020-04-16","NJ","75317","76513","0","0","3518","151830","151830","34","362","0","3522","4287","7809"
"2020-04-16","NM","1484","31910","0","215","36","33394","33394","35","0","34","467","77","544"
"2020-04-16","NV","3321","25130","0","0","137","28451","28451","32","6","0","686","110","796"
"2020-04-16","NY","222284","328295","0","48535","12192","550579","550579","36","606","1996","16062","8505","24567"
"2020-04-16","OH","8414","66426","0","2331","389","74840","74840","39","28","94","2665","623","3288"
"2020-04-16","OK","2357","28542","0","528","131","30899","30899","40","8","18","1586","94","1680"
"2020-04-16","OR","1736","33202","0","414","64","34938","34938","41","6","13","1514","73","1587"
"2020-04-16","PA","27735","113735","0","0","707","141470","141470","42","60","0","2641","1245","3886"
"2020-04-16","PR","1043","7315","1465","0","56","9823","8358","72","5","0","490","69","559"
"2020-04-16","RI","3838","24226","0","331","105","28064","28064","44","18","0","1858","309","2167"
"2020-04-16","SC","3656","31077","0","675","107","34733","34733","45","0","0","0","0","0"
"2020-04-16","SD","1311","9239","2","55","7","10552","10550","46","1","4","548","143","691"
"2020-04-16","TN","6262","78787","0","691","141","85049","85049","47","6","28","3970","183","4153"
"2020-04-16","TX","16455","142092","0","0","393","158547","158547","48","29","0","5774","963","6737"
"2020-04-16","UT","2683","46995","0","238","21","49678","49678","49","1","17","1923","141","2064"
"2020-04-16","VA","6889","39555","537","1114","208","46981","46444","51","13","66","1886","389","2275"
"2020-04-16","VI","51","357","35","0","1","443","408","78","0","0","26","0","26"
"2020-04-16","VT","768","10739","0","0","35","11507","11507","50","5","0","417","9","426"
"2020-04-16","WA","11343","134751","0","0","571","146094","146094","53","20","0","3923","243","4166"
"2020-04-16","WI","3875","40974","218","1121","197","45067","44849","55","15","30","1648","154","1802"
"2020-04-16","WV","739","17567","0","0","13","18306","18306","54","3","0","613","37","650"
"2020-04-16","WY","296","6131","0","43","2","6427","6427","56","0","0","89","9","98"
"2020-04-15","AK","293","8371","0","34","9","8664","8664","02","0","2","308","8","316"
"2020-04-15","AL","4113","29964","0","525","121","34077","34077","01","11","32","723","237","960"
"2020-04-15","AR","1569","20265","0","130","33","21834","21834","05","3","0","614","89","703"
"2020-04-15","AS","0","3","17","0","0","20","3","60","0","0","0","0","0"
"2020-04-15","AZ","3962","41348","0","0","142","45310","45310","04","11","0","1058","156","1214"
"2020-04-15","CA","24424","192062","13200","0","821","229686","216486","06","63","0","13192","1086","14278"
"2020-04-15","CO","7941","31639","0","1556","329","39580","39580","08","21","63","588","250","838"
"2020-04-15","CT","14755","35388","0","0","868","50143","50143","09","197","0","3536","766","4302"
"2020-04-15","DC","2197","9328","0","0","72","11525","11525","11","5","0","102","139","241"
"2020-04-15","DE","2014","11088","0","0","46","13102","13102","10","5","0","545","253","798"
"2020-04-15","FL","22511","190998","1335","3344","609","214844","213509","12","72","284","9185","1144","10329"
"2020-04-15","GA","14987","49103","0","2922","552","64090","64090","13","51","153","1531","764","2295"
"2020-04-15","GU","133","843","0","0","5","976","976","66","0","0","32","0","32"
"2020-04-15","HI","517","19286","0","45","9","19803","19803","15","0","1","370","13","383"
"2020-04-15","IA","1995","17874","0","0","53","19869","19869","19","4","0","888","96","984"
"2020-04-15","ID","1464","13934","0","141","39","15398","15398","16","6","6","273","11","284"
"2020-04-15","IL","24593","92336","0","0","948","116929","116929","17","80","0","4967","1346","6313"
"2020-04-15","IN","8955","39441","0","0","436","48396","48396","18","48","0","1951","428","2379"
"2020-04-15","KS","1494","13174","0","342","76","14668","14668","20","7","15","453","68","521"
"2020-04-15","KY","2210","25487","0","687","115","27697","27697","21","11","14","852","162","1014"
"2020-04-15","LA","21951","99977","0","0","1103","121928","121928","22","90","0","3073","433","3506"
"2020-04-15","MA","29970","102790","0","3637","1502","132760","132760","25","173","21","3970","1861","5831"
"2020-04-15","MD","10032","45731","0","2231","413","55763","55763","24","111","109","1470","560","2030"
"2020-04-15","ME","770","14076","0","126","24","14846","14846","23","4","2","2468","36","2504"
"2020-04-15","MI","28059","61638","0","0","1921","89697","89697","26","153","0","2413","1058","3471"
"2020-04-15","MN","1809","38433","0","445","87","40242","40242","27","8","40","887","114","1001"
"2020-04-15","MO","4895","44117","0","0","147","49012","49012","29","14","0","825","209","1034"
"2020-04-15","MP","13","27","7","0","2","47","40","69","0","0","0","0","0"
"2020-04-15","MS","3360","34791","0","645","122","38151","38151","28","11","49","0","273","273"
"2020-04-15","MT","404","9179","0","51","7","9583","9583","30","0","1","344","5","349"
"2020-04-15","NC","5123","62704","0","0","117","67827","67827","37","9","0","2689","99","2788"
"2020-04-15","ND","365","10952","0","44","9","11317","11317","38","0","2","377","24","401"
"2020-04-15","NE","901","10828","0","0","20","11729","11729","31","2","0","342","30","372"
"2020-04-15","NH","1139","11027","121","178","32","12287","12166","33","9","26","437","119","556"
"2020-04-15","NJ","71030","72991","0","0","3156","144021","144021","34","351","0","2041","2206","4247"
"2020-04-15","NM","1407","31443","0","181","36","32850","32850","35","5","0","818","62","880"
"2020-04-15","NV","3211","24444","0","0","131","27655","27655","32","11","0","871","123","994"
"2020-04-15","NY","213779","312233","0","46539","11586","526012","526012","36","752","2253","15298","11571","26869"
"2020-04-15","OH","7791","63761","0","2237","361","71552","71552","39","37","81","3040","511","3551"
"2020-04-15","OK","2263","26956","0","510","123","29219","29219","40","15","22","871","79","950"
"2020-04-15","OR","1663","31688","0","401","58","33351","33351","41","3","20","958","30","988"
"2020-04-15","PA","26490","111094","0","0","647","137584","137584","42","63","0","2808","1145","3953"
"2020-04-15","PR","974","6825","1410","0","51","9209","7799","72","6","0","541","51","592"
"2020-04-15","RI","3529","22368","0","331","87","25897","25897","44","7","0","2719","278","2997"
"2020-04-15","SC","3656","31077","0","675","107","34733","34733","45","10","0","758","103","861"
"2020-04-15","SD","1168","8691","0","51","6","9859","9859","46","0","6","383","180","563"
"2020-04-15","TN","6079","74817","0","663","135","80896","80896","47","11","30","1809","256","2065"
"2020-04-15","TX","15492","136318","0","0","364","151810","151810","48","46","0","4475","868","5343"
"2020-04-15","UT","2542","45072","0","221","20","47614","47614","49","1","8","1008","130","1138"
"2020-04-15","VA","6500","37669","496","1048","195","44665","44169","51","41","1048","1077","329","1406"
"2020-04-15","VI","51","331","35","0","1","417","382","78","0","0","5","0","5"
"2020-04-15","VT","759","10322","0","0","30","11081","11081","50","1","0","489","7","496"
"2020-04-15","WA","11100","130828","0","0","551","141928","141928","53","9","0","3719","311","4030"
"2020-04-15","WI","3721","39326","280","1091","182","43327","43047","55","12","42","1329","166","1495"
"2020-04-15","WV","702","16954","0","164","10","17656","17656","54","1","0","556","62","618"
"2020-04-15","WY","287","6042","0","43","2","6329","6329","56","1","0","353","12","365"
"2020-04-14","AK","285","8063","0","32","9","8348","8348","02","1","0","510","8","518"
"2020-04-14","AL","3876","29241","0","493","110","33117","33117","01","11","36","3793","142","3935"
"2020-04-14","AR","1480","19651","0","130","30","21131","21131","05","0","0","257","70","327"
"2020-04-14","AS","0","3","17","0","0","20","3","60","0","0","0","0","0"
"2020-04-14","AZ","3806","40290","0","0","131","44096","44096","04","9","0","645","104","749"
"2020-04-14","CA","23338","178870","13200","0","758","215408","202208","06","71","0","10336","990","11326"
"2020-04-14","CO","7691","31051","0","1493","308","38742","38742","08","4","21","1201","7","1208"
"2020-04-14","CT","13989","31852","0","0","671","45841","45841","09","69","0","924","608","1532"
"2020-04-14","DC","2058","9226","0","0","67","11284","11284","11","14","0","247","103","350"
"2020-04-14","DE","1761","10543","0","0","41","12304","12304","10","6","0","348","136","484"
"2020-04-14","FL","21367","181813","1275","3060","537","204455","203180","12","54","227","6207","766","6973"
"2020-04-14","GA","14223","47572","0","2769","501","61795","61795","13","37","180","3866","908","4774"
"2020-04-14","GU","133","811","0","0","5","944","944","66","0","0","41","0","41"
"2020-04-14","HI","504","18916","0","44","9","19420","19420","15","0","0","571","5","576"
"2020-04-14","IA","1899","16986","0","0","49","18885","18885","19","6","0","0","189","189"
"2020-04-14","ID","1453","13661","0","135","33","15114","15114","16","6","3","206","27","233"
"2020-04-14","IL","23247","87369","0","0","868","110616","110616","17","74","0","3626","1222","4848"
"2020-04-14","IN","8527","37490","0","0","388","46017","46017","18","38","0","1187","291","1478"
"2020-04-14","KS","1426","12721","0","327","69","14147","14147","20","7","18","233","50","283"
"2020-04-14","KY","2048","24635","0","673","104","26683","26683","21","7","6","732","85","817"
"2020-04-14","LA","21518","96904","0","0","1013","118422","118422","22","129","0","9829","502","10331"
"2020-04-14","MA","28109","98820","0","3616","1329","126929","126929","25","118","131","3320","1315","4635"
"2020-04-14","MD","9472","44261","0","2122","302","53733","53733","24","40","147","1446","536","1982"
"2020-04-14","ME","734","11608","0","124","20","12342","12342","23","1","0","0","36","36"
"2020-04-14","MI","27001","59225","0","0","1768","86226","86226","26","166","0","2216","1366","3582"
"2020-04-14","MN","1695","37546","0","405","79","39241","39241","27","9","44","769","45","814"
"2020-04-14","MO","4686","43292","0","0","133","47978","47978","29","19","0","2252","298","2550"
"2020-04-14","MP","13","27","7","0","2","47","40","69","0","0","0","2","2"
"2020-04-14","MS","3087","34791","0","596","111","37878","37878","28","13","47","6749","145","6894"
"2020-04-14","MT","399","8835","0","50","7","9234","9234","30","0","3","131","5","136"
"2020-04-14","NC","5024","60015","0","0","108","65039","65039","37","22","0","1443","208","1651"
"2020-04-14","ND","341","10575","0","42","9","10916","10916","38","1","2","125","10","135"
"2020-04-14","NE","871","10486","0","0","18","11357","11357","31","1","0","328","57","385"
"2020-04-14","NH","1020","10590","25","152","23","11635","11610","33","0","0","368","35","403"
"2020-04-14","NJ","68824","70950","0","0","2805","139774","139774","34","362","0","6065","4240","10305"
"2020-04-14","NM","1345","30625","0","181","31","31970","31970","35","5","181","1355","100","1455"
"2020-04-14","NV","3088","23573","0","0","120","26661","26661","32","6","0","1080","117","1197"
"2020-04-14","NY","202208","296935","0","44286","10834","499143","499143","36","778","1649","13609","7177","20786"
"2020-04-14","OH","7280","60721","0","2156","324","68001","68001","39","50","123","2584","305","2889"
"2020-04-14","OK","2184","26085","0","488","108","28269","28269","40","9","31","5295","115","5410"
"2020-04-14","OR","1633","30730","0","381","55","32363","32363","41","2","12","1193","49","1242"
"2020-04-14","PA","25345","108286","0","0","584","133631","133631","42","60","0","2693","1146","3839"
"2020-04-14","PR","923","6284","1322","0","45","8529","7207","72","0","0","324","20","344"
"2020-04-14","RI","3251","19649","0","331","80","22900","22900","44","7","0","1964","275","2239"
"2020-04-14","SC","3553","30319","0","675","97","33872","33872","45","15","179","2213","234","2447"
"2020-04-14","SD","988","8308","0","45","6","9296","9296","46","0","1","174","120","294"
"2020-04-14","TN","5823","73008","0","633","124","78831","78831","47","15","54","2423","213","2636"
"2020-04-14","TX","14624","131843","0","0","318","146467","146467","48","31","0","12523","718","13241"
"2020-04-14","UT","2412","44064","0","213","19","46476","46476","49","1","12","640","49","689"
"2020-04-14","VA","6171","36592","469","0","154","43232","42763","51","5","0","938","424","1362"
"2020-04-14","VI","51","326","23","0","1","400","377","78","0","0","4","0","4"
"2020-04-14","VT","752","9833","0","0","29","10585","10585","50","1","0","215","4","219"
"2020-04-14","WA","10789","127109","0","0","542","137898","137898","53","16","0","3828","202","4030"
"2020-04-14","WI","3555","37997","277","1049","170","41829","41552","55","16","56","1228","127","1355"
"2020-04-14","WV","640","16398","0","164","9","17038","17038","54","0","0","369","14","383"
"2020-04-14","WY","275","5689","0","43","1","5964","5964","56","0","2","0","0","0"
"2020-04-13","AK","277","7553","0","32","8","7830","7830","02","0","1","-213","5","-208"
"2020-04-13","AL","3734","25448","0","457","99","29182","29182","01","6","20","7390","209","7599"
"2020-04-13","AR","1410","19394","0","130","30","20804","20804","05","3","0","952","130","1082"
"2020-04-13","AS","0","3","0","0","0","3","3","60","0","0","0","0","0"
"2020-04-13","AZ","3702","39645","0","0","122","43347","43347","04","7","0","1075","163","1238"
"2020-04-13","CA","22348","168534","13200","0","687","204082","190882","06","36","0","0","554","554"
"2020-04-13","CO","7684","29850","0","1472","304","37534","37534","08","30","96","1870","791","2661"
"2020-04-13","CT","13381","30928","0","0","602","44309","44309","09","48","0","1743","1346","3089"
"2020-04-13","DC","1955","8979","0","0","53","10934","10934","11","3","0","214","80","294"
"2020-04-13","DE","1625","10195","0","0","35","11820","11820","10","2","0","571","146","717"
"2020-04-13","FL","20601","175606","1789","2833","483","197996","196207","12","18","61","12208","1246","13454"
"2020-04-13","GA","13315","43706","0","2589","464","57021","57021","13","31","84","1705","863","2568"
"2020-04-13","GU","133","770","0","0","5","903","903","66","0","0","77","0","77"
"2020-04-13","HI","499","18345","0","44","9","18844","18844","15","1","0","863","13","876"
"2020-04-13","IA","1710","16986","0","0","43","18696","18696","19","2","0","981","123","1104"
"2020-04-13","ID","1426","13455","0","132","27","14881","14881","16","0","1","554","19","573"
"2020-04-13","IL","22025","83743","0","0","794","105768","105768","17","74","0","3860","1173","5033"
"2020-04-13","IN","8236","36303","0","0","350","44539","44539","18","7","0","1742","308","2050"
"2020-04-13","KS","1376","12488","0","309","62","13864","13864","20","6","11","572","39","611"
"2020-04-13","KY","1963","23903","0","667","97","25866","25866","21","3","208","1176","123","1299"
"2020-04-13","LA","21016","87075","0","0","884","108091","108091","22","44","0","3625","421","4046"
"2020-04-13","MA","26794","95500","0","3485","1211","122294","122294","25","155","971","4037","1413","5450"
"2020-04-13","MD","8936","42815","0","1975","262","51751","51751","24","27","115","1276","711","1987"
"2020-04-13","ME","698","11608","0","124","19","12306","12306","23","0","4","5520","65","5585"
"2020-04-13","MI","25635","57009","0","0","1602","82644","82644","26","115","0","2210","997","3207"
"2020-04-13","MN","1650","36777","0","361","70","38427","38427","27","0","0","977","29","1006"
"2020-04-13","MO","4388","41040","0","0","114","45428","45428","29","4","0","0","228","228"
"2020-04-13","MP","11","27","9","0","2","47","38","69","0","0","0","0","0"
"2020-04-13","MS","2942","28042","0","549","98","30984","30984","28","2","1","9410","161","9571"
"2020-04-13","MT","394","8704","0","47","7","9098","9098","30","1","0","178","7","185"
"2020-04-13","NC","4816","58572","0","0","86","63388","63388","37","5","0","953","296","1249"
"2020-04-13","ND","331","10450","0","40","8","10781","10781","38","0","1","408","23","431"
"2020-04-13","NE","814","10158","0","0","17","10972","10972","31","0","0","258","23","281"
"2020-04-13","NH","985","10222","125","152","23","11332","11207","33","0","6","226","56","282"
"2020-04-13","NJ","64584","64885","0","0","2443","129469","129469","34","93","0","0","2734","2734"
"2020-04-13","NM","1245","29270","0","0","26","30515","30515","35","6","0","1752","71","1823"
"2020-04-13","NV","2971","22493","0","0","114","25464","25464","32","2","0","718","135","853"
"2020-04-13","NY","195031","283326","0","42637","10056","478357","478357","36","671","43","10419","6337","16756"
"2020-04-13","OH","6975","58137","0","2033","274","65112","65112","39","21","85","1498","371","1869"
"2020-04-13","OK","2069","20790","0","457","99","22859","22859","40","3","11","0","99","99"
"2020-04-13","OR","1584","29537","0","369","53","31121","31121","41","1","10","1306","57","1363"
"2020-04-13","PA","24199","105593","0","0","524","129792","129792","42","17","0","3536","1366","4902"
"2020-04-13","PR","903","5960","1288","0","45","8151","6863","72","1","0","141","6","147"
"2020-04-13","RI","2976","17685","0","331","73","20661","20661","44","10","331","0","311","311"
"2020-04-13","SC","3319","28106","0","496","82","31425","31425","45","0","0","0","0","0"
"2020-04-13","SD","868","8134","0","44","6","9002","9002","46","0","1","311","138","449"
"2020-04-13","TN","5610","70585","0","579","109","76195","76195","47","8","12","5216","302","5518"
"2020-04-13","TX","13906","119320","0","0","287","133226","133226","48","16","0","8271","422","8693"
"2020-04-13","UT","2363","43424","0","201","18","45787","45787","49","0","6","1493","60","1553"
"2020-04-13","VA","5747","35654","473","0","149","41874","41401","51","8","0","943","473","1416"
"2020-04-13","VI","51","322","2","0","1","375","373","78","0","0","23","0","23"
"2020-04-13","VT","748","9618","0","0","28","10366","10366","50","1","0","504","21","525"
"2020-04-13","WA","10587","123281","0","0","526","133868","133868","53","17","0","3748","189","3937"
"2020-04-13","WI","3428","36769","273","993","154","40470","40197","55","10","19","853","87","940"
"2020-04-13","WV","626","16029","0","164","9","16655","16655","54","1","164","383","15","398"
"2020-04-13","WY","275","5689","0","41","1","5964","5964","56","1","1","491","14","505"
"2020-04-12","AK","272","7766","0","31","8","8038","8038","02","0","0","291","15","306"
"2020-04-12","AL","3525","18058","0","437","93","21583","21583","01","2","35","0","334","334"
"2020-04-12","AR","1280","18442","0","130","27","19722","19722","05","3","0","1090","54","1144"
"2020-04-12","AS","0","3","2","0","0","5","3","60","0","0","0","0","0"
"2020-04-12","AZ","3539","38570","0","0","115","42109","42109","04","7","0","1433","146","1579"
"2020-04-12","CA","21794","168534","13200","0","651","203528","190328","06","42","0","15930","1179","17109"
"2020-04-12","CO","6893","27980","0","1376","274","34873","34873","08","24","64","1837","383","2220"
"2020-04-12","CT","12035","29185","0","0","554","41220","41220","09","60","0","864","525","1389"
"2020-04-12","DC","1875","8765","0","0","50","10640","10640","11","3","0","504","97","601"
"2020-04-12","DE","1479","9624","0","0","33","11103","11103","10","0","0","0","0","0"
"2020-04-12","FL","19355","163398","1297","2772","465","184050","182753","12","27","111","8959","861","9820"
"2020-04-12","GA","12452","42001","0","2505","433","54453","54453","13","5","26","2445","293","2738"
"2020-04-12","GU","133","693","0","0","5","826","826","66","0","0","0","0","0"
"2020-04-12","HI","486","17482","0","44","8","17968","17968","15","0","1","416","21","437"
"2020-04-12","IA","1587","16005","0","0","41","17592","17592","19","7","0","383","77","460"
"2020-04-12","ID","1407","12901","0","131","27","14308","14308","16","2","3","533","11","544"
"2020-04-12","IL","20852","79883","0","0","720","100735","100735","17","43","0","6914","1672","8586"
"2020-04-12","IN","7928","34561","0","0","343","42489","42489","18","13","0","2781","493","3274"
"2020-04-12","KS","1337","11916","0","298","56","13253","13253","20","1","5","841","69","910"
"2020-04-12","KY","1840","22727","0","459","94","24567","24567","21","4","0","132","147","279"
"2020-04-12","LA","20595","83450","0","0","840","104045","104045","22","34","0","6549","581","7130"
"2020-04-12","MA","25381","91463","0","2514","1056","116844","116844","25","110","7","5348","2615","7963"
"2020-04-12","MD","8225","41539","0","1860","235","49764","49764","24","29","151","1995","531","2526"
"2020-04-12","ME","633","6088","0","120","19","6721","6721","23","0","6","0","17","17"
"2020-04-12","MI","24638","54799","0","0","1487","79437","79437","26","95","0","2778","645","3423"
"2020-04-12","MN","1621","35800","0","361","70","37421","37421","27","6","21","1823","194","2017"
"2020-04-12","MO","4160","41040","0","0","110","45200","45200","29","1","0","1892","136","2028"
"2020-04-12","MP","11","27","9","0","2","47","38","69","0","0","0","0","0"
"2020-04-12","MS","2781","18632","0","548","96","21413","21413","28","3","20","0","139","139"
"2020-04-12","MT","387","8526","0","47","6","8913","8913","30","0","1","322","10","332"
"2020-04-12","NC","4520","57619","0","0","81","62139","62139","37","1","0","1538","208","1746"
"2020-04-12","ND","308","10042","0","39","8","10350","10350","38","1","3","255","15","270"
"2020-04-12","NE","791","9900","0","0","17","10691","10691","31","0","0","615","91","706"
"2020-04-12","NH","929","9996","119","146","23","11044","10925","33","1","12","388","44","432"
"2020-04-12","NJ","61850","64885","0","0","2350","126735","126735","34","167","0","2843","3699","6542"
"2020-04-12","NM","1174","27518","0","0","20","28692","28692","35","1","0","1511","83","1594"
"2020-04-12","NV","2836","21775","0","0","112","24611","24611","32","10","0","888","136","1024"
"2020-04-12","NY","188694","272907","0","42594","9385","461601","461601","36","758","1915","12385","8236","20621"
"2020-04-12","OH","6604","56639","0","1948","253","63243","63243","39","6","89","2418","354","2772"
"2020-04-12","OK","1970","20790","0","446","96","22760","22760","40","2","0","0","102","102"
"2020-04-12","OR","1527","28231","0","359","52","29758","29758","41","4","21","2378","156","2534"
"2020-04-12","PA","22833","102057","0","0","507","124890","124890","42","13","0","3559","1178","4737"
"2020-04-12","PR","897","5819","1251","0","44","7967","6716","72","2","0","236","109","345"
"2020-04-12","RI","2665","17685","0","0","63","20350","20350","44","7","0","1827","316","2143"
"2020-04-12","SC","3319","28106","0","496","82","31425","31425","45","2","0","1220","112","1332"
"2020-04-12","SD","730","7823","0","43","6","8553","8553","46","0","10","445","104","549"
"2020-04-12","TN","5308","65369","0","567","101","70677","70677","47","0","11","3655","194","3849"
"2020-04-12","TX","13484","111049","0","0","271","124533","124533","48","17","0","3077","923","4000"
"2020-04-12","UT","2303","41931","0","195","18","44234","44234","49","0","5","1591","97","1688"
"2020-04-12","VA","5274","34711","521","0","141","40506","39985","51","11","0","1789","197","1986"
"2020-04-12","VI","51","299","20","0","1","370","350","78","0","0","0","0","0"
"2020-04-12","VT","727","9114","0","0","27","9841","9841","50","2","0","567","16","583"
"2020-04-12","WA","10398","119533","0","0","509","129931","129931","53","15","0","1297","236","1533"
"2020-04-12","WI","3341","35916","0","974","144","39257","39257","55","7","24","1236","128","1364"
"2020-04-12","WV","611","15646","0","0","8","16257","16257","54","3","0","771","34","805"
"2020-04-12","WY","261","5198","0","40","0","5459","5459","56","0","3","0","0","0"
"2020-04-11","AK","257","7475","0","31","8","7732","7732","02","1","3","289","11","300"
"2020-04-11","AL","3191","18058","0","402","91","21249","21249","01","11","34","0","223","223"
"2020-04-11","AR","1226","17352","0","130","24","18578","18578","05","1","0","1403","55","1458"
"2020-04-11","AS","0","3","2","0","0","5","3","60","0","0","0","0","0"
"2020-04-11","AZ","3393","37137","0","0","108","40530","40530","04","11","0","2515","281","2796"
"2020-04-11","CA","20615","152604","13200","0","609","186419","173219","06","68","0","7213","1143","8356"
"2020-04-11","CO","6510","26143","0","1312","250","32653","32653","08","0","0","0","0","0"
"2020-04-11","CT","11510","28321","0","0","494","39831","39831","09","46","0","2571","972","3543"
"2020-04-11","DC","1778","8261","0","0","47","10039","10039","11","9","0","566","118","684"
"2020-04-11","DE","1479","9624","0","0","33","11103","11103","10","10","0","-791","153","-638"
"2020-04-11","FL","18494","154439","1418","2661","438","174351","172933","12","48","174","9140","963","10103"
"2020-04-11","GA","12159","39556","0","2479","428","51715","51715","13","12","128","4892","676","5568"
"2020-04-11","GU","133","693","0","0","5","826","826","66","1","0","31","3","34"
"2020-04-11","HI","465","17066","0","43","8","17531","17531","15","2","1","1359","23","1382"
"2020-04-11","IA","1510","15622","0","0","34","17132","17132","19","3","0","1057","122","1179"
"2020-04-11","ID","1396","12368","0","128","25","13764","13764","16","1","1","627","43","670"
"2020-04-11","IL","19180","72969","0","0","677","92149","92149","17","81","0","3329","1293","4622"
"2020-04-11","IN","7435","31780","0","0","330","39215","39215","18","30","0","3647","528","4175"
"2020-04-11","KS","1268","11075","0","293","55","12343","12343","20","5","19","827","102","929"
"2020-04-11","KY","1693","22595","0","459","90","24288","24288","21","0","0","0","0","0"
"2020-04-11","LA","20014","76901","0","0","806","96915","96915","22","51","0","3874","761","4635"
"2020-04-11","MA","22766","86115","0","2507","946","108881","108881","25","114","72","4551","1888","6439"
"2020-04-11","MD","7694","39544","0","1709","206","47238","47238","24","35","296","2064","726","2790"
"2020-04-11","ME","616","6088","0","114","19","6704","6704","23","2","3","0","30","30"
"2020-04-11","MI","23993","52021","0","0","1392","76014","76014","26","111","0","2760","1210","3970"
"2020-04-11","MN","1427","33977","0","340","64","35404","35404","27","7","23","1419","91","1510"
"2020-04-11","MO","4024","39148","0","0","109","43172","43172","29","13","0","2207","225","2432"
"2020-04-11","MP","11","27","9","0","2","47","38","69","0","0","0","0","0"
"2020-04-11","MS","2642","18632","0","528","93","21274","21274","28","11","46","0","173","173"
"2020-04-11","MT","377","8204","0","46","6","8581","8581","30","0","5","272","12","284"
"2020-04-11","NC","4312","56081","0","0","80","60393","60393","37","6","0","2344","404","2748"
"2020-04-11","ND","293","9787","0","36","7","10080","10080","38","1","0","457","15","472"
"2020-04-11","NE","700","9285","0","0","17","9985","9985","31","2","0","566","65","631"
"2020-04-11","NH","885","9608","93","134","22","10586","10493","33","1","10","469","66","535"
"2020-04-11","NJ","58151","62042","0","0","2183","120193","120193","34","251","0","3107","3563","6670"
"2020-04-11","NM","1091","26007","0","0","19","27098","27098","35","0","0","0","0","0"
"2020-04-11","NV","2700","20887","0","0","102","23587","23587","32","16","0","722","116","838"
"2020-04-11","NY","180458","260522","0","40679","8627","440980","440980","36","783","1861","13149","9946","23095"
"2020-04-11","OH","6250","54221","0","1859","247","60471","60471","39","16","104","1526","372","1898"
"2020-04-11","OK","1868","20790","0","446","94","22658","22658","40","6","18","420","74","494"
"2020-04-11","OR","1371","25853","0","338","48","27224","27224","41","4","12","1547","50","1597"
"2020-04-11","PA","21655","98498","0","0","494","120153","120153","42","78","0","5458","1676","7134"
"2020-04-11","PR","788","5583","1332","0","42","7703","6371","72","3","0","462","63","525"
"2020-04-11","RI","2349","15858","0","0","56","18207","18207","44","7","0","3577","334","3911"
"2020-04-11","SC","3207","26886","0","496","80","30093","30093","45","8","0","1768","142","1910"
"2020-04-11","SD","626","7378","2","33","6","8006","8004","46","0","4","267","90","357"
"2020-04-11","TN","5114","61714","0","556","101","66828","66828","47","3","20","3777","252","4029"
"2020-04-11","TX","12561","107972","0","0","254","120533","120533","48","28","0","3925","890","4815"
"2020-04-11","UT","2206","40340","0","190","18","42546","42546","49","1","7","1680","104","1784"
"2020-04-11","VA","5077","32922","517","0","130","38516","37999","51","9","0","1972","568","2540"
"2020-04-11","VI","51","299","20","0","1","370","350","78","0","0","26","1","27"
"2020-04-11","VT","711","8547","0","0","25","9258","9258","50","1","0","994","32","1026"
"2020-04-11","WA","10162","118236","0","0","494","128398","128398","53","18","0","1840","221","2061"
"2020-04-11","WI","3213","34680","0","950","137","37893","37893","55","9","46","1455","145","1600"
"2020-04-11","WV","577","14875","0","0","5","15452","15452","54","0","0","874","23","897"
"2020-04-11","WY","261","5198","0","37","0","5459","5459","56","0","0","462","8","470"
"2020-04-10","AK","246","7186","0","28","7","7432","7432","02","0","1","198","11","209"
"2020-04-10","AL","2968","18058","0","368","80","21026","21026","01","6","35","0","199","199"
"2020-04-10","AR","1171","15949","0","130","23","17120","17120","05","2","0","2117","52","2169"
"2020-04-10","AS","0","3","2","0","0","5","3","60","0","0","0","0","0"
"2020-04-10","AZ","3112","34622","0","0","97","37734","37734","04","8","0","462","94","556"
"2020-04-10","CA","19472","145391","13900","0","541","178763","164863","06","49","0","200","1163","1363"
"2020-04-10","CO","6510","26143","0","1312","250","32653","32653","08","57","150","2599","855","3454"
"2020-04-10","CT","10538","25750","0","0","448","36288","36288","09","68","0","2032","754","2786"
"2020-04-10","DC","1660","7695","0","0","38","9355","9355","11","6","0","494","137","631"
"2020-04-10","DE","1326","10415","0","0","23","11741","11741","10","0","0","1732","119","1851"
"2020-04-10","FL","17531","145299","1411","2487","390","164241","162830","12","36","219","9114","1167","10281"
"2020-04-10","GA","11483","34664","0","2351","416","46147","46147","13","37","192","4145","917","5062"
"2020-04-10","GU","130","662","0","0","4","792","792","66","0","0","69","2","71"
"2020-04-10","HI","442","15707","0","42","6","16149","16149","15","1","0","391","7","398"
"2020-04-10","IA","1388","14565","0","0","31","15953","15953","19","2","0","862","118","980"
"2020-04-10","ID","1353","11741","0","127","24","13094","13094","16","6","14","442","121","563"
"2020-04-10","IL","17887","69640","0","0","596","87527","87527","17","68","0","5205","1465","6670"
"2020-04-10","IN","6907","28133","0","0","300","35040","35040","18","55","0","2351","556","2907"
"2020-04-10","KS","1166","10248","0","274","50","11414","11414","20","8","11","579","60","639"
"2020-04-10","KY","1693","22595","0","459","90","24288","24288","21","17","459","2140","347","2487"
"2020-04-10","LA","19253","73027","0","0","755","92280","92280","22","53","0","4391","970","5361"
"2020-04-10","MA","20878","81564","0","2435","832","102442","102442","25","107","133","5418","2035","7453"
"2020-04-10","MD","6968","37480","0","1413","171","44448","44448","24","33","65","2136","783","2919"
"2020-04-10","ME","586","6088","0","111","17","6674","6674","23","1","6","0","26","26"
"2020-04-10","MI","22783","49261","0","0","1281","72044","72044","26","205","0","3711","1279","4990"
"2020-04-10","MN","1336","32558","0","317","57","33894","33894","27","7","24","1506","94","1600"
"2020-04-10","MO","3799","36941","0","0","96","40740","40740","29","19","0","1986","260","2246"
"2020-04-10","MP","11","27","9","0","2","47","38","69","0","0","0","0","0"
"2020-04-10","MS","2469","18632","0","482","82","21101","21101","28","6","41","0","209","209"
"2020-04-10","MT","365","7932","0","41","6","8297","8297","30","0","5","426","11","437"
"2020-04-10","NC","3908","53737","0","0","74","57645","57645","37","9","0","9579","257","9836"
"2020-04-10","ND","278","9330","0","36","6","9608","9608","38","1","2","609","9","618"
"2020-04-10","NE","635","8719","0","0","15","9354","9354","31","1","0","603","68","671"
"2020-04-10","NH","819","9139","155","124","21","10113","9958","33","3","6","376","31","407"
"2020-04-10","NJ","54588","58935","0","0","1932","113523","113523","34","232","0","2770","3561","6331"
"2020-04-10","NM","1091","26007","0","0","19","27098","27098","35","3","0","3065","226","3291"
"2020-04-10","NV","2584","20165","0","0","86","22749","22749","32","6","0","850","128","978"
"2020-04-10","NY","170512","247373","0","38818","7844","417885","417885","36","777","2242","15761","10575","26336"
"2020-04-10","OH","5878","52695","0","1755","231","58573","58573","39","18","143","2222","366","2588"
"2020-04-10","OK","1794","20370","0","428","88","22164","22164","40","8","13","1775","110","1885"
"2020-04-10","OR","1321","24306","0","326","44","25627","25627","41","0","0","0","0","0"
"2020-04-10","PA","19979","93040","0","0","416","113019","113019","42","78","0","5666","1751","7417"
"2020-04-10","PR","725","5121","1392","0","39","7238","5846","72","6","0","418","42","460"
"2020-04-10","RI","2015","12281","0","0","49","14296","14296","44","6","0","1599","288","1887"
"2020-04-10","SC","3065","25118","0","496","72","28183","28183","45","5","255","543","273","816"
"2020-04-10","SD","536","7111","0","29","6","7647","7647","46","0","2","411","89","500"
"2020-04-10","TN","4862","57937","0","536","98","62799","62799","47","4","31","2722","228","2950"
"2020-04-10","TX","11671","104047","0","0","226","115718","115718","48","27","0","8143","1441","9584"
"2020-04-10","UT","2102","38660","0","183","17","40762","40762","49","4","15","2263","126","2389"
"2020-04-10","VA","4509","30950","521","772","121","35980","35459","51","12","87","1966","467","2433"
"2020-04-10","VI","50","273","45","0","1","368","323","78","0","0","22","4","26"
"2020-04-10","VT","679","7553","0","0","24","8232","8232","50","1","0","0","51","51"
"2020-04-10","WA","9941","116396","0","0","476","126337","126337","53","17","0","3852","449","4301"
"2020-04-10","WI","3068","33225","0","904","128","36293","36293","55","17","61","1801","183","1984"
"2020-04-10","WV","554","14001","0","0","5","14555","14555","54","0","0","661","31","692"
"2020-04-10","WY","253","4736","0","37","0","4989","4989","56","0","3","816","23","839"
"2020-04-09","AK","235","6988","0","27","7","7223","7223","02","0","0","146","9","155"
"2020-04-09","AL","2769","18058","0","333","74","20827","20827","01","8","19","1305","400","1705"
"2020-04-09","AR","1119","13832","0","130","21","14951","14951","05","3","0","302","119","421"
"2020-04-09","AS","0","3","2","0","0","5","3","60","0","0","0","0","0"
"2020-04-09","AZ","3018","34160","0","0","89","37178","37178","04","9","0","2322","292","2614"
"2020-04-09","CA","18309","145191","14100","0","492","177600","163500","06","50","0","17884","1352","19236"
"2020-04-09","CO","5655","23544","0","1162","193","29199","29199","08","14","83","879","226","1105"
"2020-04-09","CT","9784","23718","0","0","380","33502","33502","09","103","0","2463","2003","4466"
"2020-04-09","DC","1523","7201","0","0","32","8724","8724","11","5","0","358","83","441"
"2020-04-09","DE","1207","8683","0","0","23","9890","9890","10","7","0","1055","279","1334"
"2020-04-09","FL","16364","136185","1395","2268","354","153944","152549","12","45","206","8506","909","9415"
"2020-04-09","GA","10566","30519","0","2159","379","41085","41085","13","17","166","1633","665","2298"
"2020-04-09","GU","128","593","0","0","4","721","721","66","0","0","31","3","34"
"2020-04-09","HI","435","15316","0","42","5","15751","15751","15","0","0","577","25","602"
"2020-04-09","IA","1270","13703","0","0","29","14973","14973","19","2","0","882","125","1007"
"2020-04-09","ID","1232","11299","0","113","18","12531","12531","16","3","20","611","22","633"
"2020-04-09","IL","16422","64435","0","0","528","80857","80857","17","66","0","4447","1344","5791"
"2020-04-09","IN","6351","25782","0","0","245","32133","32133","18","42","0","856","408","1264"
"2020-04-09","KS","1106","9669","0","263","42","10775","10775","20","4","40","532","60","592"
"2020-04-09","KY","1346","20455","0","0","73","21801","21801","21","8","0","0","197","197"
"2020-04-09","LA","18283","68636","0","0","702","86919","86919","22","50","0","4260","1253","5513"
"2020-04-09","MA","18843","76146","0","2302","725","94989","94989","25","110","183","5297","2151","7448"
"2020-04-09","MD","6185","35344","0","1348","138","41529","41529","24","14","138","2411","656","3067"
"2020-04-09","ME","560","6088","0","105","16","6648","6648","23","2","4","0","23","23"
"2020-04-09","MI","21504","45550","0","0","1076","67054","67054","26","117","0","0","915","915"
"2020-04-09","MN","1242","31052","0","293","50","32294","32294","27","11","22","1453","88","1541"
"2020-04-09","MO","3539","34955","0","0","77","38494","38494","29","19","0","4172","212","4384"
"2020-04-09","MP","11","27","9","0","2","47","38","69","0","0","0","0","0"
"2020-04-09","MS","2260","18632","0","441","76","20892","20892","28","9","31","0","257","257"
"2020-04-09","MT","354","7506","0","36","6","7860","7860","30","0","5","440","22","462"
"2020-04-09","NC","3651","44158","0","0","65","47809","47809","37","12","0","4597","225","4822"
"2020-04-09","ND","269","8721","0","34","5","8990","8990","38","1","0","420","18","438"
"2020-04-09","NE","567","8116","0","0","14","8683","8683","31","2","0","674","48","722"
"2020-04-09","NH","788","8763","143","118","18","9694","9551","33","0","0","374","0","374"
"2020-04-09","NJ","51027","56165","0","0","1700","107192","107192","34","196","0","3186","3590","6776"
"2020-04-09","NM","865","22942","0","0","16","23807","23807","35","3","0","1491","71","1562"
"2020-04-09","NV","2456","19315","0","0","80","21771","21771","32","9","0","1067","138","1205"
"2020-04-09","NY","159937","231612","0","36576","7067","391549","391549","36","799","2144","15775","10621","26396"
"2020-04-09","OH","5512","50473","0","1612","213","55985","55985","39","20","117","2280","364","2644"
"2020-04-09","OK","1684","18595","0","415","80","20279","20279","40","1","25","6774","160","6934"
"2020-04-09","OR","1321","24306","0","326","44","25627","25627","41","11","2","981","82","1063"
"2020-04-09","PA","18228","87374","0","0","338","105602","105602","42","29","0","5075","1989","7064"
"2020-04-09","PR","683","4703","1304","0","33","6690","5386","72","9","0","437","63","500"
"2020-04-09","RI","1727","10682","0","0","43","12409","12409","44","8","0","0","277","277"
"2020-04-09","SC","2792","24575","0","241","67","27367","27367","45","4","0","2493","240","2733"
"2020-04-09","SD","447","6700","0","27","6","7147","7147","46","0","1","345","54","399"
"2020-04-09","TN","4634","55215","0","505","94","59849","59849","47","15","56","2959","272","3231"
"2020-04-09","TX","10230","95904","0","0","199","106134","106134","48","22","0","8999","877","9876"
"2020-04-09","UT","1976","36397","0","168","13","38373","38373","49","0","10","2127","130","2257"
"2020-04-09","VA","4042","28984","627","685","109","33653","33026","51","34","70","1984","397","2381"
"2020-04-09","VI","46","251","42","0","1","339","297","78","0","0","9","1","10"
"2020-04-09","VT","628","7553","0","0","23","8181","8181","50","0","0","409","23","432"
"2020-04-09","WA","9492","112544","0","0","459","122036","122036","53","16","0","3697","278","3975"
"2020-04-09","WI","2885","31424","0","843","111","34309","34309","55","12","53","1309","129","1438"
"2020-04-09","WV","523","13340","0","0","5","13863","13863","54","1","0","1257","61","1318"
"2020-04-09","WY","230","3920","0","34","0","4150","4150","56","0","1","77","9","86"
"2020-04-08","AK","226","6842","0","27","7","7068","7068","02","1","4","142","13","155"
"2020-04-08","AL","2369","16753","0","314","66","19122","19122","01","10","43","3956","250","4206"
"2020-04-08","AR","1000","13530","0","130","18","14530","14530","05","2","-18","838","54","892"
"2020-04-08","AS","0","3","2","0","0","5","3","60","0","0","0","0","0"
"2020-04-08","AZ","2726","31838","0","0","80","34564","34564","04","7","0","1038","151","1189"
"2020-04-08","CA","16957","127307","14600","0","442","158864","144264","06","68","0","11943","1092","13035"
"2020-04-08","CO","5429","22665","0","1079","179","28094","28094","08","29","85","962","257","1219"
"2020-04-08","CT","7781","21255","0","0","277","29036","29036","09","0","0","0","0","0"
"2020-04-08","DC","1440","6843","0","0","27","8283","8283","11","5","0","231","229","460"
"2020-04-08","DE","928","7628","0","0","16","8556","8556","10","0","0","0","0","0"
"2020-04-08","FL","15455","127679","1324","2062","309","144458","143134","12","13","63","4264","708","4972"
"2020-04-08","GA","9901","28886","0","1993","362","38787","38787","13","33","219","3991","1083","5074"
"2020-04-08","GU","125","562","0","0","4","687","687","66","0","0","33","4","37"
"2020-04-08","HI","410","14739","0","42","5","15149","15149","15","0","16","1584","23","1607"
"2020-04-08","IA","1145","12821","0","193","27","13966","13966","19","1","0","1151","97","1248"
"2020-04-08","ID","1210","10688","0","93","15","11898","11898","16","2","10","612","40","652"
"2020-04-08","IL","15078","59988","0","0","462","75066","75066","17","82","0","4805","1529","6334"
"2020-04-08","IN","5943","24926","0","0","203","30869","30869","18","30","0","1669","436","2105"
"2020-04-08","KS","1046","9137","0","223","38","10183","10183","20","11","0","523","146","669"
"2020-04-08","KY","1149","20455","0","0","65","21604","21604","21","6","0","1508","141","1649"
"2020-04-08","LA","17030","64376","0","0","652","81406","81406","22","70","0","6005","746","6751"
"2020-04-08","MA","16692","70849","0","2119","615","87541","87541","25","100","288","4579","1588","6167"
"2020-04-08","MD","5529","32933","0","1210","124","38462","38462","24","21","104","5677","1158","6835"
"2020-04-08","ME","537","6088","0","101","14","6625","6625","23","2","2","0","18","18"
"2020-04-08","MI","20589","45550","0","0","959","66139","66139","26","114","0","0","766","766"
"2020-04-08","MN","1154","29599","0","271","39","30753","30753","27","5","29","1408","85","1493"
"2020-04-08","MO","3327","30783","0","0","58","34110","34110","29","5","0","1851","290","2141"
"2020-04-08","MP","11","27","9","0","2","47","38","69","0","0","12","3","15"
"2020-04-08","MS","2003","18632","0","410","67","20635","20635","28","8","33","0","88","88"
"2020-04-08","MT","332","7066","0","31","6","7398","7398","30","0","3","400","13","413"
"2020-04-08","NC","3426","39561","0","0","53","42987","42987","37","7","0","1700","205","1905"
"2020-04-08","ND","251","8301","0","34","4","8552","8552","38","0","1","835","14","849"
"2020-04-08","NE","519","7442","0","0","12","7961","7961","31","2","0","631","72","703"
"2020-04-08","NH","788","8389","89","118","18","9266","9177","33","9","15","370","73","443"
"2020-04-08","NJ","47437","52979","0","0","1504","100416","100416","34","272","0","2421","3021","5442"
"2020-04-08","NM","794","21451","0","0","13","22245","22245","35","1","0","312","108","420"
"2020-04-08","NV","2318","18248","0","0","71","20566","20566","32","13","0","1696","231","1927"
"2020-04-08","NY","149316","215837","0","34432","6268","365153","365153","36","779","2349","14642","10453","25095"
"2020-04-08","OH","5148","48193","0","1495","193","53341","53341","39","26","141","2137","366","2503"
"2020-04-08","OK","1524","11821","0","390","79","13345","13345","40","12","14","0","52","52"
"2020-04-08","OR","1239","23325","0","324","33","24564","24564","41","0","0","1499","58","1557"
"2020-04-08","PA","16239","82299","0","0","309","98538","98538","42","69","0","5580","1680","7260"
"2020-04-08","PR","620","4266","1160","0","24","6046","4886","72","1","0","300","47","347"
"2020-04-08","RI","1450","10682","0","0","35","12132","12132","44","5","0","1605","220","1825"
"2020-04-08","SC","2552","22082","0","241","63","24634","24634","45","12","0","819","135","954"
"2020-04-08","SD","393","6355","0","26","6","6748","6748","46","0","3","407","73","480"
"2020-04-08","TN","4362","52256","0","449","79","56618","56618","47","7","41","3520","224","3744"
"2020-04-08","TX","9353","86905","0","0","177","96258","96258","48","23","0","6518","1091","7609"
"2020-04-08","UT","1846","34270","0","158","13","36116","36116","49","0","10","1361","108","1469"
"2020-04-08","VA","3645","27000","0","615","75","30645","30645","51","12","52","1688","312","2000"
"2020-04-08","VI","45","242","35","0","1","322","287","78","0","0","20","2","22"
"2020-04-08","VT","605","7144","0","50","23","7749","7749","50","0","5","590","30","620"
"2020-04-08","WA","9214","108847","0","0","443","118061","118061","53","14","0","4336","355","4691"
"2020-04-08","WI","2756","30115","0","790","99","32871","32871","55","7","45","1603","178","1781"
"2020-04-08","WV","462","12083","0","0","4","12545","12545","54","0","0","436","50","486"
"2020-04-08","WY","221","3843","0","33","0","4064","4064","56","0","0","54","5","59"
"2020-04-07","AK","213","6700","0","23","6","6913","6913","02","0","0","8","22","30"
"2020-04-07","AL","2119","12797","0","271","56","14916","14916","01","6","31","0","151","151"
"2020-04-07","AR","946","12692","0","148","16","13638","13638","05","0","11","722","71","793"
"2020-04-07","AS","0","3","2","0","0","5","3","60","0","0","0","0","0"
"2020-04-07","AZ","2575","30800","0","0","73","33375","33375","04","8","0","722","119","841"
"2020-04-07","CA","15865","115364","14100","0","374","145329","131229","06","31","0","12269","1529","13798"
"2020-04-07","CO","5172","21703","0","994","150","26875","26875","08","10","70","880","222","1102"
"2020-04-07","CT","7781","21255","0","0","277","29036","29036","09","71","0","1475","875","2350"
"2020-04-07","DC","1211","6612","0","0","22","7823","7823","11","-2","0","256","114","370"
"2020-04-07","DE","928","7628","0","0","16","8556","8556","10","2","0","1307","255","1562"
"2020-04-07","FL","14747","123415","1407","1999","296","139569","138162","12","60","317","13465","1423","14888"
"2020-04-07","GA","8818","24895","0","1774","329","33713","33713","13","100","442","935","1504","2439"
"2020-04-07","GU","121","529","0","0","4","650","650","66","0","0","24","8","32"
"2020-04-07","HI","387","13155","0","26","5","13542","13542","15","1","5","0","16","16"
"2020-04-07","IA","1048","11670","0","193","26","12718","12718","19","1","14","1017","102","1119"
"2020-04-07","ID","1170","10076","0","83","13","11246","11246","16","3","6","182","69","251"
"2020-04-07","IL","13549","55183","0","0","380","68732","68732","17","73","0","4503","1287","5790"
"2020-04-07","IN","5507","23257","0","0","173","28764","28764","18","34","0","2010","563","2573"
"2020-04-07","KS","900","8614","0","223","27","9514","9514","20","2","25","375","55","430"
"2020-04-07","KY","1008","18947","0","0","59","19955","19955","21","14","0","1135","53","1188"
"2020-04-07","LA","16284","58371","0","0","582","74655","74655","22","70","0","4072","1417","5489"
"2020-04-07","MA","15104","66270","0","1831","515","81374","81374","25","67","164","3550","1365","4915"
"2020-04-07","MD","4371","27256","0","1106","103","31627","31627","24","12","47","1684","326","2010"
"2020-04-07","ME","519","6088","0","99","12","6607","6607","23","2","7","0","20","20"
"2020-04-07","MI","19823","45550","0","0","845","65373","65373","26","118","0","2430","973","3403"
"2020-04-07","MN","1069","28191","0","242","34","29260","29260","27","4","19","1049","83","1132"
"2020-04-07","MO","3037","28932","0","0","53","31969","31969","29","14","0","1819","315","2134"
"2020-04-07","MP","8","15","0","0","2","23","23","69","1","0","2","0","2"
"2020-04-07","MS","1915","18632","0","377","59","20547","20547","28","8","-98","0","177","177"
"2020-04-07","MT","319","6666","0","28","6","6985","6985","30","0","4","175","20","195"
"2020-04-07","NC","3221","37861","0","0","46","41082","41082","37","13","0","5","351","356"
"2020-04-07","ND","237","7466","0","33","4","7703","7703","38","1","1","478","12","490"
"2020-04-07","NE","447","6811","0","0","10","7258","7258","31","2","0","433","38","471"
"2020-04-07","NH","715","8019","49","103","9","8783","8734","33","0","11","318","46","364"
"2020-04-07","NJ","44416","50558","0","0","1232","94974","94974","34","229","0","2616","3326","5942"
"2020-04-07","NM","686","21139","0","0","12","21825","21825","35","0","0","2627","62","2689"
"2020-04-07","NV","2087","16552","0","0","58","18639","18639","32","12","0","876","134","1010"
"2020-04-07","NY","138863","201195","0","32083","5489","340058","340058","36","731","1880","11073","8174","19247"
"2020-04-07","OH","4782","46056","0","1354","167","50838","50838","39","25","140","2128","332","2460"
"2020-04-07","OK","1472","11821","0","376","67","13293","13293","40","16","36","10399","145","10544"
"2020-04-07","OR","1181","21826","0","324","33","23007","23007","41","6","66","1157","49","1206"
"2020-04-07","PA","14559","76719","0","0","240","91278","91278","42","78","0","5845","1579","7424"
"2020-04-07","PR","573","3966","968","0","23","5507","4539","72","2","0","534","60","594"
"2020-04-07","RI","1230","9077","0","0","30","10307","10307","44","3","0","1678","148","1826"
"2020-04-07","SC","2417","21263","0","241","51","23680","23680","45","7","0","4336","368","4704"
"2020-04-07","SD","320","5948","2","23","6","6270","6268","46","2","0","216","32","248"
"2020-04-07","TN","4138","48736","0","408","72","52874","52874","47","7","56","5188","336","5524"
"2020-04-07","TX","8262","80387","0","0","154","88649","88649","48","14","0","2306","986","3292"
"2020-04-07","UT","1738","32909","0","148","13","34647","34647","49","0","10","1190","63","1253"
"2020-04-07","VA","3333","25312","0","563","63","28645","28645","51","9","66","3669","455","4124"
"2020-04-07","VI","43","222","20","0","1","285","265","78","0","0","0","0","0"
"2020-04-07","VT","575","6554","0","45","23","7129","7129","50","0","0","464","32","496"
"2020-04-07","WA","8859","104511","0","0","429","113370","113370","53","22","0","4674","336","5010"
"2020-04-07","WI","2578","28512","0","745","92","31090","31090","55","15","77","1938","138","2076"
"2020-04-07","WV","412","11647","0","0","4","12059","12059","54","0","0","2052","67","2119"
"2020-04-07","WY","216","3789","0","33","0","4005","4005","56","0","10","70","6","76"
"2020-04-06","AK","191","6692","0","23","6","6883","6883","02","0","3","593","6","599"
"2020-04-06","AL","1968","12797","0","240","50","14765","14765","01","5","9","1515","172","1687"
"2020-04-06","AR","875","11970","0","137","16","12845","12845","05","0","7","1558","45","1603"
"2020-04-06","AS","0","3","2","0","0","5","3","60","0","0","0","0","0"
"2020-04-06","AZ","2456","30078","0","0","65","32534","32534","04","1","0","4937","187","5124"
"2020-04-06","CA","14336","103095","15000","0","343","132431","117431","06","24","0","0","898","898"
"2020-04-06","CO","4950","20823","0","924","140","25773","25773","08","14","49","1488","385","1873"
"2020-04-06","CT","6906","19780","0","0","206","26686","26686","09","17","0","2185","1231","3416"
"2020-04-06","DC","1097","6356","0","0","24","7453","7453","11","2","0","520","99","619"
"2020-04-06","DE","673","6321","0","0","14","6994","6994","10","0","0","0","0","0"
"2020-04-06","FL","13324","109950","1142","1682","236","124416","123274","12","18","110","8697","1173","9870"
"2020-04-06","GA","7314","23960","0","1332","229","31274","31274","13","18","49","2775","667","3442"
"2020-04-06","GU","113","505","0","0","4","618","618","66","0","0","12","1","13"
"2020-04-06","HI","371","13155","0","21","4","13526","13526","15","0","2","551","20","571"
"2020-04-06","IA","946","10653","0","179","25","11599","11599","19","3","14","680","78","758"
"2020-04-06","ID","1101","9894","0","77","10","10995","10995","16","0","11","710","24","734"
"2020-04-06","IL","12262","50680","0","0","307","62942","62942","17","33","0","2953","1006","3959"
"2020-04-06","IN","4944","21247","0","0","139","26191","26191","18","12","0","3006","533","3539"
"2020-04-06","KS","845","8239","0","198","25","9084","9084","20","3","15","763","98","861"
"2020-04-06","KY","955","17812","0","0","45","18767","18767","21","5","0","2066","38","2104"
"2020-04-06","LA","14867","54299","0","0","512","69166","69166","22","35","0","6984","1857","8841"
"2020-04-06","MA","13739","62720","0","1667","448","76459","76459","25","78","35","3155","1337","4492"
"2020-04-06","MD","4045","25572","0","1059","91","29617","29617","24","24","123","844","436","1280"
"2020-04-06","ME","499","6088","0","92","10","6587","6587","23","0","6","0","29","29"
"2020-04-06","MI","18850","43120","0","0","727","61970","61970","26","110","0","2789","1283","4072"
"2020-04-06","MN","986","27142","0","223","30","28128","28128","27","1","21","1300","51","1351"
"2020-04-06","MO","2722","27113","0","0","39","29835","29835","29","5","0","2231","355","2586"
"2020-04-06","MP","8","13","10","0","1","31","21","69","0","0","0","0","0"
"2020-04-06","MS","1738","18632","0","475","51","20370","20370","28","8","0","13052","100","13152"
"2020-04-06","MT","299","6491","0","24","6","6790","6790","30","0","0","174","13","187"
"2020-04-06","NC","2870","37856","0","0","33","40726","40726","37","2","0","396","285","681"
"2020-04-06","ND","225","6988","0","32","3","7213","7213","38","0","1","408","18","426"
"2020-04-06","NE","409","6378","8","0","8","6795","6787","31","0","0","820","46","866"
"2020-04-06","NH","669","7701","101","92","9","8471","8370","33","0","6","290","48","338"
"2020-04-06","NJ","41090","47942","0","0","1003","89032","89032","34","86","0","3281","3585","6866"
"2020-04-06","NM","624","18512","0","0","12","19136","19136","35","1","0","2227","81","2308"
"2020-04-06","NV","1953","15676","0","0","46","17629","17629","32","0","0","681","117","798"
"2020-04-06","NY","130689","190122","0","30203","4758","320811","320811","36","599","2111","9873","8658","18531"
"2020-04-06","OH","4450","43928","0","1214","142","48378","48378","39","23","110","4215","407","4622"
"2020-04-06","OK","1327","1422","0","340","51","2749","2749","40","5","10","21","75","96"
"2020-04-06","OR","1132","20669","0","258","27","21801","21801","41","0","0","1113","64","1177"
"2020-04-06","PA","12980","70874","0","1145","162","83854","83854","42","12","73","4613","1470","6083"
"2020-04-06","PR","513","3432","1000","0","21","4945","3945","72","1","0","359","38","397"
"2020-04-06","RI","1082","7399","0","0","27","8481","8481","44","2","0","1140","160","1300"
"2020-04-06","SC","2049","16927","0","241","44","18976","18976","45","0","0","0","0","0"
"2020-04-06","SD","288","5732","0","23","4","6020","6020","46","2","1","379","48","427"
"2020-04-06","TN","3802","43548","0","352","65","47350","47350","47","21","24","1881","169","2050"
"2020-04-06","TX","7276","78081","0","0","140","85357","85357","48","13","0","13955","464","14419"
"2020-04-06","UT","1675","31719","0","138","13","33394","33394","49","5","14","2432","70","2502"
"2020-04-06","VA","2878","21643","0","497","54","24521","24521","51","3","66","609","241","850"
"2020-04-06","VI","43","222","20","0","1","285","265","78","0","0","16","1","17"
"2020-04-06","VT","543","6090","0","45","23","6633","6633","50","1","0","20","31","51"
"2020-04-06","WA","8523","99837","0","0","407","108360","108360","53","21","0","4551","342","4893"
"2020-04-06","WI","2440","26574","0","668","77","29014","29014","55","9","44","1405","173","1578"
"2020-04-06","WV","345","9595","0","0","4","9940","9940","54","1","0","1081","21","1102"
"2020-04-06","WY","210","3719","0","23","0","3929","3929","56","0","0","679","13","692"
"2020-04-05","AK","185","6099","0","20","6","6284","6284","02","1","4","230","14","244"
"2020-04-05","AL","1796","11282","0","231","45","13078","13078","01","2","19","2009","216","2225"
"2020-04-05","AR","830","10412","0","130","16","11242","11242","05","2","24","785","87","872"
"2020-04-05","AS","0","3","2","0","0","5","3","60","0","0","0","0","0"
"2020-04-05","AZ","2269","25141","0","0","64","27410","27410","04","12","0","0","250","250"
"2020-04-05","CA","13438","103095","15000","0","319","131533","116533","06","43","0","1421","1412","2833"
"2020-04-05","CO","4565","19335","0","875","126","23900","23900","08","15","52","1437","392","1829"
"2020-04-05","CT","5675","17595","0","0","189","23270","23270","09","24","0","842","399","1241"
"2020-04-05","DC","998","5836","0","0","22","6834","6834","11","1","0","300","96","396"
"2020-04-05","DE","673","6321","0","0","14","6994","6994","10","0","0","447","80","527"
"2020-04-05","FL","12151","101253","1129","1572","218","114533","113404","12","27","110","10297","1040","11337"
"2020-04-05","GA","6647","21185","0","1283","211","27832","27832","13","10","44","1051","487","1538"
"2020-04-05","GU","112","493","0","0","4","605","605","66","0","0","21","19","40"
"2020-04-05","HI","351","12604","0","19","4","12955","12955","15","1","1","645","32","677"
"2020-04-05","IA","868","9973","0","165","22","10841","10841","19","8","12","519","82","601"
"2020-04-05","ID","1077","9184","0","66","10","10261","10261","16","0","4","1327","64","1391"
"2020-04-05","IL","11256","47727","0","0","274","58983","58983","17","31","0","4503","899","5402"
"2020-04-05","IN","4411","18241","0","0","127","22652","22652","18","11","0","2394","458","2852"
"2020-04-05","KS","747","7476","0","183","22","8223","8223","20","1","11","596","49","645"
"2020-04-05","KY","917","15746","0","0","40","16663","16663","21","3","0","1005","86","1091"
"2020-04-05","LA","13010","47315","0","0","477","60325","60325","22","68","0","1313","514","1827"
"2020-04-05","MA","12402","59565","0","1632","370","71967","71967","25","66","262","2374","765","3139"
"2020-04-05","MD","3609","24728","0","936","67","28337","28337","24","14","115","2243","484","2727"
"2020-04-05","ME","470","6088","0","86","10","6558","6558","23","0","3","0","14","14"
"2020-04-05","MI","17567","40331","0","0","617","57898","57898","26","77","0","2926","1172","4098"
"2020-04-05","MN","935","25842","0","202","29","26777","26777","27","5","22","1284","70","1354"
"2020-04-05","MO","2367","24882","0","0","34","27249","27249","29","10","0","2268","76","2344"
"2020-04-05","MP","8","13","10","0","1","31","21","69","0","0","0","0","0"
"2020-04-05","MS","1638","5580","0","475","43","7218","7218","28","8","39","447","183","630"
"2020-04-05","MT","286","6317","0","24","6","6603","6603","30","1","0","405","21","426"
"2020-04-05","NC","2585","37460","0","0","31","40045","40045","37","7","0","1089","183","1272"
"2020-04-05","ND","207","6580","0","31","3","6787","6787","38","0","1","559","21","580"
"2020-04-05","NE","363","5558","12","0","8","5933","5921","31","2","0","500","42","542"
"2020-04-05","NH","621","7411","93","86","9","8125","8032","33","2","6","446","81","527"
"2020-04-05","NJ","37505","44661","0","0","917","82166","82166","34","71","0","3429","3381","6810"
"2020-04-05","NM","543","16285","0","0","11","16828","16828","35","1","0","1148","48","1196"
"2020-04-05","NV","1836","14995","0","0","46","16831","16831","32","0","0","574","94","668"
"2020-04-05","NY","122031","180249","0","28092","4159","302280","302280","36","594","1709","10332","8327","18659"
"2020-04-05","OH","4043","39713","0","1104","119","43756","43756","39","17","98","1581","304","1885"
"2020-04-05","OK","1252","1401","0","330","46","2653","2653","40","4","14","39","93","132"
"2020-04-05","OR","1068","19556","0","258","27","20624","20624","41","1","19","3021","69","3090"
"2020-04-05","PA","11510","66261","0","1072","150","77771","77771","42","14","68","6248","1493","7741"
"2020-04-05","PR","475","3073","1039","0","20","4587","3548","72","2","0","468","23","491"
"2020-04-05","RI","922","6259","0","0","25","7181","7181","44","8","0","675","116","791"
"2020-04-05","SC","2049","16927","0","241","44","18976","18976","45","4","0","530","132","662"
"2020-04-05","SD","240","5353","0","22","2","5593","5593","46","0","3","341","28","369"
"2020-04-05","TN","3633","41667","0","328","44","45300","45300","47","1","17","3597","312","3909"
"2020-04-05","TX","6812","64126","0","0","127","70938","70938","48","22","0","6485","702","7187"
"2020-04-05","UT","1605","29287","0","124","8","30892","30892","49","0","7","2672","177","2849"
"2020-04-05","VA","2637","21034","0","431","51","23671","23671","51","-1","41","1889","230","2119"
"2020-04-05","VI","42","206","18","0","1","266","248","78","1","0","22","2","24"
"2020-04-05","VT","512","6070","0","45","22","6582","6582","50","2","0","687","51","738"
"2020-04-05","WA","8181","95286","0","0","386","103467","103467","53","21","0","1757","389","2146"
"2020-04-05","WI","2267","25169","0","624","68","27436","27436","55","12","36","1310","155","1465"
"2020-04-05","WV","324","8514","0","0","3","8838","8838","54","1","0","1110","42","1152"
"2020-04-05","WY","197","3040","0","23","0","3237","3237","56","0","0","95","10","105"
"2020-04-04","AK","171","5869","0","16","5","6040","6040","02","2","1","10","14","24"
"2020-04-04","AL","1580","9273","0","212","43","10853","10853","01","8","212","1086","148","1234"
"2020-04-04","AR","743","9627","0","106","14","10370","10370","05","2","1","632","39","671"
"2020-04-04","AS","0","3","2","0","0","5","3","60","0","0","0","0","0"
"2020-04-04","AZ","2019","25141","0","0","52","27160","27160","04","11","0","2237","250","2487"
"2020-04-04","CA","12026","101674","13000","0","276","126700","113700","06","39","0","77075","1325","78400"
"2020-04-04","CO","4173","17898","0","823","111","22071","22071","08","14","113","1215","445","1660"
"2020-04-04","CT","5276","16753","0","0","165","22029","22029","09","34","0","1652","362","2014"
"2020-04-04","DC","902","5536","0","0","21","6438","6438","11","6","0","709","145","854"
"2020-04-04","DE","593","5874","0","0","14","6467","6467","10","0","0","879","143","1022"
"2020-04-04","FL","11111","90956","1281","1462","191","103348","102067","12","28","175","8819","1526","10345"
"2020-04-04","GA","6160","20134","0","1239","201","26294","26294","13","17","81","700","329","1029"
"2020-04-04","GU","93","472","0","0","4","565","565","66","0","0","13","9","22"
"2020-04-04","HI","319","11959","0","18","3","12278","12278","15","1","3","1753","34","1787"
"2020-04-04","IA","786","9454","0","153","14","10240","10240","19","3","15","700","87","787"
"2020-04-04","ID","1013","7857","0","62","10","8870","8870","16","1","6","803","122","925"
"2020-04-04","IL","10357","43224","0","0","243","53581","53581","17","33","0","4080","1453","5533"
"2020-04-04","IN","3953","15847","0","0","116","19800","19800","18","14","0","1449","516","1965"
"2020-04-04","KS","698","6880","0","172","21","7578","7578","20","4","21","426","78","504"
"2020-04-04","KY","831","14741","0","0","37","15572","15572","21","6","0","2707","61","2768"
"2020-04-04","LA","12496","46002","0","0","409","58498","58498","22","39","0","2654","2199","4853"
"2020-04-04","MA","11637","57191","0","1370","304","68828","68828","25","39","404","4506","1334","5840"
"2020-04-04","MD","3125","22485","0","821","53","25610","25610","24","11","157","1553","367","1920"
"2020-04-04","ME","456","6088","0","83","10","6544","6544","23","1","8","0","24","24"
"2020-04-04","MI","16395","37405","0","0","540","53800","53800","26","61","0","3735","1143","4878"
"2020-04-04","MN","865","24558","0","180","24","25423","25423","27","2","24","1120","76","1196"
"2020-04-04","MO","2291","22614","0","0","24","24905","24905","29","5","0","3257","178","3435"
"2020-04-04","MP","8","13","10","0","1","31","21","69","0","0","0","0","0"
"2020-04-04","MS","1455","5133","0","436","35","6588","6588","28","6","16","380","97","477"
"2020-04-04","MT","265","5912","0","24","5","6177","6177","30","0","0","579","22","601"
"2020-04-04","NC","2402","36371","0","0","24","38773","38773","37","5","0","6866","309","7175"
"2020-04-04","ND","186","6021","0","30","3","6207","6207","38","0","1","396","13","409"
"2020-04-04","NE","321","5058","10","0","6","5389","5379","31","0","0","571","42","613"
"2020-04-04","NH","540","6965","94","80","7","7599","7505","33","2","7","390","61","451"
"2020-04-04","NJ","34124","41232","0","0","846","75356","75356","34","200","0","3624","4229","7853"
"2020-04-04","NM","495","15137","0","0","10","15632","15632","35","3","0","762","92","854"
"2020-04-04","NV","1742","14421","0","0","46","16163","16163","32","3","0","1403","228","1631"
"2020-04-04","NY","113704","169917","0","26383","3565","283621","283621","36","630","2687","12260","10841","23101"
"2020-04-04","OH","3739","38132","0","1006","102","41871","41871","39","11","111","3069","427","3496"
"2020-04-04","OK","1159","1362","0","316","42","2521","2521","40","4","27","47","171","218"
"2020-04-04","OR","999","16535","0","239","26","17534","17534","41","4","35","0","100","100"
"2020-04-04","PA","10017","60013","0","1004","136","70030","70030","42","34","152","6318","1597","7915"
"2020-04-04","PR","452","2605","1129","0","18","4186","3057","72","3","0","556","74","630"
"2020-04-04","RI","806","5584","0","0","17","6390","6390","44","3","0","727","97","824"
"2020-04-04","SC","1917","16397","0","241","40","18314","18314","45","9","0","10956","363","11319"
"2020-04-04","SD","212","5012","1","19","2","5225","5224","46","0","2","419","25","444"
"2020-04-04","TN","3321","38070","0","311","43","41391","41391","47","6","18","3298","254","3552"
"2020-04-04","TX","6110","57641","0","0","105","63751","63751","48","15","0","7207","780","7987"
"2020-04-04","UT","1428","26615","0","117","8","28043","28043","49","1","11","3613","182","3795"
"2020-04-04","VA","2407","19145","0","390","52","21552","21552","51","6","78","2152","395","2547"
"2020-04-04","VI","40","184","42","0","0","266","224","78","0","0","30","2","32"
"2020-04-04","VT","461","5383","0","45","20","5844","5844","50","3","0","544","72","616"
"2020-04-04","WA","7792","93529","0","0","365","101321","101321","53","27","0","2345","368","2713"
"2020-04-04","WI","2112","23859","0","588","56","25971","25971","55","19","101","1482","200","1682"
"2020-04-04","WV","282","7404","0","0","2","7686","7686","54","0","0","1274","45","1319"
"2020-04-04","WY","187","2945","0","23","0","3132","3132","56","0","2","241","25","266"
"2020-04-03","AK","157","5859","0","15","3","6016","6016","02","0","6","980","14","994"
"2020-04-03","AL","1432","8187","0","0","35","9619","9619","01","3","0","684","199","883"
"2020-04-03","AR","704","8995","0","105","12","9699","9699","05","0","5","1115","61","1176"
"2020-04-03","AS","0","3","2","0","0","5","3","60","0","0","0","0","0"
"2020-04-03","AZ","1769","22904","0","0","41","24673","24673","04","9","0","1793","171","1964"
"2020-04-03","CA","10701","24599","59500","0","237","94800","35300","06","34","0","790","1510","2300"
"2020-04-03","CO","3728","16683","0","710","97","20411","20411","08","17","90","1380","386","1766"
"2020-04-03","CT","4914","15101","0","0","131","20015","20015","09","19","0","625","1090","1715"
"2020-04-03","DC","757","4827","0","0","15","5584","5584","11","3","0","410","104","514"
"2020-04-03","DE","450","4995","0","0","14","5445","5445","10","2","0","429","57","486"
"2020-04-03","FL","9585","82137","1225","1287","163","92947","91722","12","35","164","12851","1575","14426"
"2020-04-03","GA","5831","19434","0","1158","184","25265","25265","13","21","102","1825","483","2308"
"2020-04-03","GU","84","459","0","0","4","543","543","66","1","0","17","2","19"
"2020-04-03","HI","285","10206","0","15","2","10491","10491","15","1","0","0","27","27"
"2020-04-03","IA","699","8754","0","138","11","9453","9453","19","0","18","700","85","785"
"2020-04-03","ID","891","7054","0","56","9","7945","7945","16","0","7","441","222","663"
"2020-04-03","IL","8904","39144","0","0","210","48048","48048","17","53","0","3183","1209","4392"
"2020-04-03","IN","3437","14398","0","0","102","17835","17835","18","24","0","1152","398","1550"
"2020-04-03","KS","620","6454","0","151","17","7074","7074","20","4","13","395","68","463"
"2020-04-03","KY","770","12034","0","0","31","12804","12804","21","11","0","4814","90","4904"
"2020-04-03","LA","10297","43348","0","0","370","53645","53645","22","60","0","1412","1147","2559"
"2020-04-03","MA","10303","52685","0","966","265","62988","62988","25","36","153","4918","1436","6354"
"2020-04-03","MD","2758","20932","0","664","42","23690","23690","24","6","82","2042","427","2469"
"2020-04-03","ME","432","6088","0","75","9","6520","6520","23","2","7","0","56","56"
"2020-04-03","MI","15252","33670","0","0","479","48922","48922","26","62","0","3302","1135","4437"
"2020-04-03","MN","789","23438","0","156","22","24227","24227","27","4","18","1786","47","1833"
"2020-04-03","MO","2113","19357","0","0","19","21470","21470","29","0","0","1508","279","1787"
"2020-04-03","MP","8","13","10","0","1","31","21","69","0","0","0","0","0"
"2020-04-03","MS","1358","4753","0","420","29","6111","6111","28","3","60","0","181","181"
"2020-04-03","MT","243","5333","0","24","5","5576","5576","30","0","4","240","16","256"
"2020-04-03","NC","2093","29505","0","0","19","31598","31598","37","3","0","2683","236","2919"
"2020-04-03","ND","173","5625","0","29","3","5798","5798","38","0","1","804","14","818"
"2020-04-03","NE","279","4487","11","0","6","4777","4766","31","1","0","509","33","542"
"2020-04-03","NH","479","6575","114","73","5","7168","7054","33","1","15","497","64","561"
"2020-04-03","NJ","29895","37608","0","0","646","67503","67503","34","109","0","4088","4305","8393"
"2020-04-03","NM","403","14375","0","0","7","14778","14778","35","1","0","727","40","767"
"2020-04-03","NV","1514","13018","0","0","43","14532","14532","32","5","0","430","56","486"
"2020-04-03","NY","102863","157657","0","23696","2935","260520","260520","36","562","2879","11073","10482","21555"
"2020-04-03","OH","3312","35063","0","895","91","38375","38375","39","10","93","3047","410","3457"
"2020-04-03","OK","988","1315","0","289","38","2303","2303","40","4","32","50","109","159"
"2020-04-03","OR","899","16535","0","204","22","17434","17434","41","1","16","1276","73","1349"
"2020-04-03","PA","8420","53695","0","852","102","62115","62115","42","12","122","5997","1404","7401"
"2020-04-03","PR","378","2049","1055","0","15","3482","2427","72","3","0","445","62","507"
"2020-04-03","RI","709","4857","0","0","14","5566","5566","44","2","0","445","52","497"
"2020-04-03","SC","1554","5441","0","241","31","6995","6995","45","0","0","0","0","0"
"2020-04-03","SD","187","4593","3","17","2","4783","4780","46","0","0","376","22","398"
"2020-04-03","TN","3067","34772","0","293","37","37839","37839","47","5","30","3006","222","3228"
"2020-04-03","TX","5330","50434","0","0","90","55764","55764","48","20","0","4424","661","5085"
"2020-04-03","UT","1246","23002","0","106","7","24248","24248","49","0","6","2847","172","3019"
"2020-04-03","VA","2012","16993","0","312","46","19005","19005","51","5","7","1110","306","1416"
"2020-04-03","VI","38","154","56","0","0","248","192","78","0","0","5","5","10"
"2020-04-03","VT","389","4839","0","45","17","5228","5228","50","0","0","128","51","179"
"2020-04-03","WA","7424","91184","0","0","338","98608","98608","53","28","0","4295","531","4826"
"2020-04-03","WI","1912","22377","0","487","37","24289","24289","55","6","26","2060","182","2242"
"2020-04-03","WV","237","6130","0","1","2","6367","6367","54","0","0","854","20","874"
"2020-04-03","WY","162","2704","0","21","0","2866","2866","56","0","2","265","12","277"
"2020-04-02","AK","143","4879","0","9","3","5022","5022","02","0","0","409","10","419"
"2020-04-02","AL","1233","7503","0","0","32","8736","8736","01","6","0","806","156","962"
"2020-04-02","AR","643","7880","0","100","12","8523","8523","05","2","10","526","59","585"
"2020-04-02","AS","0","3","2","0","0","5","3","60","0","0","0","0","0"
"2020-04-02","AZ","1598","21111","0","0","32","22709","22709","04","3","0","1466","185","1651"
"2020-04-02","CA","9191","23809","59500","0","203","92500","33000","06","32","0","2037","1036","3073"
"2020-04-02","CO","3342","15303","0","620","80","18645","18645","08","11","111","1420","376","1796"
"2020-04-02","CT","3824","14476","0","0","112","18300","18300","09","27","0","1433","267","1700"
"2020-04-02","DC","653","4417","0","0","12","5070","5070","11","1","0","1155","67","1222"
"2020-04-02","DE","393","4566","0","0","12","4959","4959","10","1","0","551","25","576"
"2020-04-02","FL","8010","69286","1285","1123","128","78581","77296","12","41","174","9757","1055","10812"
"2020-04-02","GA","5348","17609","0","1056","163","22957","22957","13","24","104","1921","710","2631"
"2020-04-02","GU","82","442","0","0","3","524","524","66","0","0","36","5","41"
"2020-04-02","HI","258","10206","0","15","1","10464","10464","15","0","2","1485","50","1535"
"2020-04-02","IA","614","8054","0","120","11","8668","8668","19","2","21","750","65","815"
"2020-04-02","ID","669","6613","0","49","9","7282","7282","16","0","3","537","144","681"
"2020-04-02","IL","7695","35961","0","0","157","43656","43656","17","16","0","2557","715","3272"
"2020-04-02","IN","3039","13246","0","0","78","16285","16285","18","13","0","1436","474","1910"
"2020-04-02","KS","552","6059","0","138","13","6611","6611","20","3","24","648","70","718"
"2020-04-02","KY","680","7220","0","0","20","7900","7900","21","3","0","255","89","344"
"2020-04-02","LA","9150","41936","0","0","310","51086","51086","22","37","0","2584","2726","5310"
"2020-04-02","MA","8867","47767","0","813","229","56634","56634","25","42","131","3642","1228","4870"
"2020-04-02","MD","2331","18890","0","582","36","21221","21221","24","5","60","1657","346","2003"
"2020-04-02","ME","376","6088","0","68","7","6464","6464","23","0","5","0","32","32"
"2020-04-02","MI","14117","30368","0","0","417","44485","44485","26","80","0","3131","1229","4360"
"2020-04-02","MN","742","21652","0","138","18","22394","22394","27","1","16","1150","53","1203"
"2020-04-02","MO","1834","17849","0","0","19","19683","19683","29","1","0","2003","253","2256"
"2020-04-02","MP","8","13","12","0","1","33","21","69","1","0","13","2","15"
"2020-04-02","MS","1177","4753","0","360","26","5930","5930","28","4","28","1041","104","1145"
"2020-04-02","MT","227","5093","0","20","5","5320","5320","30","0","3","383","19","402"
"2020-04-02","NC","1857","26822","0","0","16","28679","28679","37","6","0","2163","273","2436"
"2020-04-02","ND","159","4821","0","28","3","4980","4980","38","0","5","470","17","487"
"2020-04-02","NE","246","3978","11","0","5","4235","4224","31","1","0","503","36","539"
"2020-04-02","NH","415","6078","126","58","4","6619","6493","33","0","2","93","0","93"
"2020-04-02","NJ","25590","33520","0","0","537","59110","59110","34","182","0","3133","3335","6468"
"2020-04-02","NM","363","13648","0","0","6","14011","14011","35","1","0","723","48","771"
"2020-04-02","NV","1458","12588","0","0","38","14046","14046","32","12","0","1069","179","1248"
"2020-04-02","NY","92381","146584","0","20817","2373","238965","238965","36","432","2449","9416","8669","18085"
"2020-04-02","OH","2902","32016","0","802","81","34918","34918","39","16","123","5024","355","5379"
"2020-04-02","OK","879","1265","0","257","34","2144","2144","40","4","38","17","160","177"
"2020-04-02","OR","826","15259","0","188","21","16085","16085","41","3","34","2123","90","2213"
"2020-04-02","PA","7016","47698","0","730","90","54714","54714","42","16","110","5271","1211","6482"
"2020-04-02","PR","316","1604","1119","0","12","3039","1920","72","1","0","195","30","225"
"2020-04-02","RI","657","4412","0","0","12","5069","5069","44","2","0","581","91","672"
"2020-04-02","SC","1554","5441","0","241","31","6995","6995","45","5","139","408","261","669"
"2020-04-02","SD","165","4217","0","17","2","4382","4382","46","0","5","314","36","350"
"2020-04-02","TN","2845","31766","0","263","32","34611","34611","47","8","63","1997","162","2159"
"2020-04-02","TX","4669","46010","0","0","70","50679","50679","48","12","0","2150","672","2822"
"2020-04-02","UT","1074","20155","0","100","7","21229","21229","49","0","9","0","62","62"
"2020-04-02","VA","1706","15883","0","305","41","17589","17589","51","7","0","2023","222","2245"
"2020-04-02","VI","33","149","42","0","0","224","182","78","0","0","23","3","26"
"2020-04-02","VT","338","4711","0","45","17","5049","5049","50","1","0","537","17","554"
"2020-04-02","WA","6893","86889","0","0","310","93782","93782","53","28","0","4332","353","4685"
"2020-04-02","WI","1730","20317","0","461","31","22047","22047","55","7","63","1498","180","1678"
"2020-04-02","WV","217","5276","0","1","2","5493","5493","54","1","0","892","26","918"
"2020-04-02","WY","150","2439","0","19","0","2589","2589","56","0","1","221","20","241"
"2020-04-01","AK","133","4470","0","9","3","4603","4603","02","0","2","876","14","890"
"2020-04-01","AL","1077","6697","0","0","26","7774","7774","01","13","0","399","96","495"
"2020-04-01","AR","584","7354","0","90","10","7938","7938","05","2","90","1395","61","1456"
"2020-04-01","AS","0","3","2","0","0","5","3","60","0","0","0","0","0"
"2020-04-01","AZ","1413","19645","0","0","29","21058","21058","04","5","0","1563","124","1687"
"2020-04-01","CA","8155","21772","57400","0","171","87327","29927","06","18","0","0","673","673"
"2020-04-01","CO","2966","13883","0","509","69","16849","16849","08","18","95","1146","339","1485"
"2020-04-01","CT","3557","13043","0","0","85","16600","16600","09","16","0","14","429","443"
"2020-04-01","DC","586","3262","2","0","11","3850","3848","11","2","0","0","91","91"
"2020-04-01","DE","368","4015","0","0","11","4383","4383","10","1","0","319","49","368"
"2020-04-01","FL","6955","59529","1235","949","87","67719","66484","12","10","126","5244","617","5861"
"2020-04-01","GA","4638","15688","0","952","139","20326","20326","13","28","119","3436","709","4145"
"2020-04-01","GU","77","406","0","0","3","483","483","66","1","0","35","8","43"
"2020-04-01","HI","208","8721","0","13","1","8929","8929","15","1","1","250","4","254"
"2020-04-01","IA","549","7304","0","99","9","7853","7853","19","2","5","416","52","468"
"2020-04-01","ID","525","6076","0","46","9","6601","6601","16","2","1","779","110","889"
"2020-04-01","IL","6980","33404","0","0","141","40384","40384","17","42","0","4173","986","5159"
"2020-04-01","IN","2565","11810","0","0","65","14375","14375","18","16","0","596","406","1002"
"2020-04-01","KS","482","5411","0","114","10","5893","5893","20","1","35","415","54","469"
"2020-04-01","KY","591","6965","0","0","17","7556","7556","21","6","0","635","111","746"
"2020-04-01","LA","6424","39352","0","0","273","45776","45776","22","34","0","5622","1187","6809"
"2020-04-01","MA","7639","44125","0","682","187","51764","51764","25","34","120","3685","1118","4803"
"2020-04-01","MD","1985","17233","0","522","31","19218","19218","24","13","93","2365","325","2690"
"2020-04-01","ME","344","6088","0","63","7","6432","6432","23","2","6","0","41","41"
"2020-04-01","MI","12888","27237","0","0","337","40125","40125","26","78","0","3258","1013","4271"
"2020-04-01","MN","689","20502","0","122","17","21191","21191","27","5","10","1351","60","1411"
"2020-04-01","MO","1581","15846","0","0","18","17427","17427","29","4","0","1232","254","1486"
"2020-04-01","MP","6","0","0","0","0","6","6","69","0","0","0","4","4"
"2020-04-01","MS","1073","3712","0","332","22","4785","4785","28","2","121","175","136","311"
"2020-04-01","MT","208","4710","0","17","5","4918","4918","30","1","3","476","24","500"
"2020-04-01","NC","1584","24659","0","0","10","26243","26243","37","2","0","3051","86","3137"
"2020-04-01","ND","142","4351","0","23","3","4493","4493","38","0","2","220","16","236"
"2020-04-01","NE","210","3475","8","0","4","3693","3685","31","1","0","544","38","582"
"2020-04-01","NH","415","5985","97","56","4","6497","6400","33","1","11","572","101","673"
"2020-04-01","NJ","22255","30387","0","0","355","52642","52642","34","88","0","3310","3559","6869"
"2020-04-01","NM","315","12925","0","0","5","13240","13240","35","1","0","679","34","713"
"2020-04-01","NV","1279","11519","0","0","26","12798","12798","32","9","0","838","166","1004"
"2020-04-01","NY","83712","137168","0","18368","1941","220880","220880","36","391","2464","7777","7917","15694"
"2020-04-01","OH","2547","26992","0","679","65","29539","29539","39","10","94","0","348","348"
"2020-04-01","OK","719","1248","0","219","30","1967","1967","40","7","42","19","154","173"
"2020-04-01","OR","736","13136","0","154","18","13872","13872","41","0","0","0","46","46"
"2020-04-01","PA","5805","42427","0","620","74","48232","48232","42","11","106","4782","962","5744"
"2020-04-01","PR","286","1409","897","0","11","2592","1695","72","3","0","214","47","261"
"2020-04-01","RI","566","3831","0","0","10","4397","4397","44","2","0","355","77","432"
"2020-04-01","SC","1293","5033","0","102","26","6326","6326","45","4","0","417","210","627"
"2020-04-01","SD","129","3903","0","12","2","4032","4032","46","1","0","294","21","315"
"2020-04-01","TN","2683","29769","0","200","24","32452","32452","47","1","25","4648","444","5092"
"2020-04-01","TX","3997","43860","0","0","58","47857","47857","48","17","0","4134","731","4865"
"2020-04-01","UT","1012","20155","0","91","7","21167","21167","49","2","18","2529","125","2654"
"2020-04-01","VA","1484","13860","0","305","34","15344","15344","51","7","140","1709","234","1943"
"2020-04-01","VI","30","126","24","0","0","180","156","78","0","0","0","0","0"
"2020-04-01","VT","321","4174","0","45","16","4495","4495","50","3","9","217","28","245"
"2020-04-01","WA","6540","82557","0","0","282","89097","89097","53","20","0","4173","491","4664"
"2020-04-01","WI","1550","18819","0","398","24","20369","20369","55","8","61","1444","199","1643"
"2020-04-01","WV","191","4384","0","1","1","4575","4575","54","0","0","403","29","432"
"2020-04-01","WY","130","2218","0","18","0","2348","2348","56","0","1","219","21","240"
"2020-03-31","AK","119","3594","0","7","3","3713","3713","02","0","0","54","5","59"
"2020-03-31","AL","981","6298","0","0","13","7279","7279","01","7","0","604","122","726"
"2020-03-31","AR","523","5959","0","0","8","6482","6482","05","1","0","697","50","747"
"2020-03-31","AS","0","3","2","0","0","5","3","60","0","0","3","0","3"
"2020-03-31","AZ","1289","18082","0","0","24","19371","19371","04","4","0","2480","132","2612"
"2020-03-31","CA","7482","21772","57400","0","153","86654","29254","06","20","0","1223","1035","2258"
"2020-03-31","CO","2627","12737","0","414","51","15364","15364","08","0","0","0","0","0"
"2020-03-31","CT","3128","13029","0","0","69","16157","16157","09","33","0","1000","557","1557"
"2020-03-31","DC","495","3262","2","0","9","3759","3757","11","0","0","580","94","674"
"2020-03-31","DE","319","3696","0","0","10","4015","4015","10","4","0","1480","55","1535"
"2020-03-31","FL","6338","54285","1163","823","77","61786","60623","12","14","171","6060","865","6925"
"2020-03-31","GA","3929","12252","0","833","111","16181","16181","13","24","126","2337","1120","3457"
"2020-03-31","GU","69","371","0","0","2","440","440","66","1","0","19","11","30"
"2020-03-31","HI","204","8471","0","12","0","8675","8675","15","0","0","646","29","675"
"2020-03-31","IA","497","6888","0","94","7","7385","7385","19","1","20","726","73","799"
"2020-03-31","ID","415","5297","0","45","7","5712","5712","16","1","6","901","105","1006"
"2020-03-31","IL","5994","29231","0","0","99","35225","35225","17","26","0","3842","937","4779"
"2020-03-31","IN","2159","11214","0","0","49","13373","13373","18","14","0","1342","373","1715"
"2020-03-31","KS","428","4996","0","79","9","5424","5424","20","1","13","442","60","502"
"2020-03-31","KY","480","6330","0","0","11","6810","6810","21","2","0","751","41","792"
"2020-03-31","LA","5237","33730","0","0","239","38967","38967","22","54","0","3722","1212","4934"
"2020-03-31","MA","6521","40440","0","562","153","46961","46961","25","29","109","3274","868","4142"
"2020-03-31","MD","1660","14868","0","429","18","16528","16528","24","3","76","1552","247","1799"
"2020-03-31","ME","303","6088","0","57","5","6391","6391","23","2","8","2694","28","2722"
"2020-03-31","MI","11875","23979","0","0","259","35854","35854","26","75","0","2796","974","3770"
"2020-03-31","MN","629","19151","0","112","12","19780","19780","27","2","20","905","53","958"
"2020-03-31","MO","1327","14614","0","0","14","15941","15941","29","1","0","1410","296","1706"
"2020-03-31","MP","2","0","0","0","0","2","2","69","0","0","0","0","0"
"2020-03-31","MS","937","3537","0","211","20","4474","4474","28","4","16","548","90","638"
"2020-03-31","MT","184","4234","0","14","4","4418","4418","30","0","4","91","13","104"
"2020-03-31","NC","1498","21608","0","0","8","23106","23106","37","2","0","2051","191","2242"
"2020-03-31","ND","126","4131","0","21","3","4257","4257","38","1","2","403","17","420"
"2020-03-31","NE","172","2931","8","0","3","3111","3103","31","1","0","347","27","374"
"2020-03-31","NH","314","5413","65","45","3","5792","5727","33","0","0","27","0","27"
"2020-03-31","NJ","18696","27077","0","0","267","45773","45773","34","69","0","1853","2060","3913"
"2020-03-31","NM","281","12246","0","0","4","12527","12527","35","2","0","1304","44","1348"
"2020-03-31","NV","1113","10681","0","0","17","11794","11794","32","2","0","474","105","579"
"2020-03-31","NY","75795","129391","0","15904","1550","205186","205186","36","332","2183","9420","9298","18718"
"2020-03-31","OH","2199","26992","0","585","55","29191","29191","39","16","110","1650","266","1916"
"2020-03-31","OK","565","1229","0","177","23","1794","1794","40","6","24","22","84","106"
"2020-03-31","OR","690","13136","0","154","18","13826","13826","41","2","14","859","84","943"
"2020-03-31","PA","4843","37645","0","514","63","42488","42488","42","14","128","3868","756","4624"
"2020-03-31","PR","239","1195","854","0","8","2288","1434","72","2","0","264","65","329"
"2020-03-31","RI","489","3476","0","0","8","3965","3965","44","4","0","289","87","376"
"2020-03-31","SC","1083","4616","0","102","22","5699","5699","45","4","0","456","158","614"
"2020-03-31","SD","108","3609","0","12","1","3717","3717","46","0","12","131","7","138"
"2020-03-31","TN","2239","25121","0","175","23","27360","27360","47","10","27","3651","405","4056"
"2020-03-31","TX","3266","39726","0","0","41","42992","42992","48","7","0","6723","389","7112"
"2020-03-31","UT","887","17626","0","73","5","18513","18513","49","1","73","2429","81","2510"
"2020-03-31","VA","1250","12151","0","165","27","13401","13401","51","2","29","1133","230","1363"
"2020-03-31","VI","30","126","24","0","0","180","156","78","0","0","0","0","0"
"2020-03-31","VT","293","3957","0","36","13","4250","4250","50","1","18","283","37","320"
"2020-03-31","WA","6049","78384","0","0","262","84433","84433","53","14","0","4126","460","4586"
"2020-03-31","WI","1351","17375","0","337","16","18726","18726","55","2","337","1519","130","1649"
"2020-03-31","WV","162","3981","0","1","1","4143","4143","54","0","0","997","36","1033"
"2020-03-31","WY","109","1999","0","17","0","2108","2108","56","0","0","159","15","174"
"2020-03-30","AK","114","3540","0","7","3","3654","3654","02","1","1","308","12","320"
"2020-03-30","AL","859","5694","0","0","6","6553","6553","01","2","0","1510","53","1563"
"2020-03-30","AR","473","5262","0","0","7","5735","5735","05","1","0","2235","47","2282"
"2020-03-30","AS","0","0","0","0","0","0","0","60","0","0","0","0","0"
"2020-03-30","AZ","1157","15602","0","0","20","16759","16759","04","3","0","2649","238","2887"
"2020-03-30","CA","6447","20549","64400","0","133","91396","26996","06","10","0","0","739","739"
"2020-03-30","CO","2627","12737","0","414","51","15364","15364","08","7","140","1522","566","2088"
"2020-03-30","CT","2571","12029","0","0","36","14600","14600","09","2","0","2122","578","2700"
"2020-03-30","DC","401","2682","2","0","9","3085","3083","11","4","0","213","59","272"
"2020-03-30","DE","264","2216","0","0","6","2480","2480","10","0","0","2180","32","2212"
"2020-03-30","FL","5473","48225","0","652","63","53698","53698","12","7","58","9155","1227","10382"
"2020-03-30","GA","2809","9915","0","707","87","12724","12724","13","7","41","2","158","160"
"2020-03-30","GU","58","352","0","0","1","410","410","66","0","0","18","2","20"
"2020-03-30","HI","175","7825","0","12","0","8000","8000","15","0","0","976","24","1000"
"2020-03-30","IA","424","6162","0","74","6","6586","6586","19","2","6","1149","88","1237"
"2020-03-30","ID","310","4396","0","39","6","4706","4706","16","1","3","375","49","424"
"2020-03-30","IL","5057","25389","0","0","73","30446","30446","17","8","0","2223","461","2684"
"2020-03-30","IN","1786","9872","0","0","35","11658","11658","18","3","0","1556","272","1828"
"2020-03-30","KS","368","4554","0","66","8","4922","4922","20","2","11","360","49","409"
"2020-03-30","KY","439","5579","0","0","9","6018","6018","21","0","0","432","45","477"
"2020-03-30","LA","4025","30008","0","0","185","34033","34033","22","34","0","5677","485","6162"
"2020-03-30","MA","5653","37166","0","453","124","42819","42819","25","25","54","2932","797","3729"
"2020-03-30","MD","1413","13316","0","353","15","14729","14729","24","5","76","962","174","1136"
"2020-03-30","ME","275","3394","0","49","3","3669","3669","23","0","49","0","22","22"
"2020-03-30","MI","10901","21183","0","0","184","32084","32084","26","52","0","5507","891","6398"
"2020-03-30","MN","576","18246","0","92","10","18822","18822","27","1","17","1092","73","1165"
"2020-03-30","MO","1031","13204","0","0","13","14235","14235","29","3","0","1657","193","1850"
"2020-03-30","MP","2","0","0","0","0","2","2","69","0","0","0","0","0"
"2020-03-30","MS","847","2989","0","195","16","3836","3836","28","2","-40","429","89","518"
"2020-03-30","MT","171","4143","0","10","4","4314","4314","30","3","2","0","17","17"
"2020-03-30","NC","1307","19557","0","0","6","20864","20864","37","2","0","1652","267","1919"
"2020-03-30","ND","109","3728","0","19","2","3837","3837","38","1","2","373","11","384"
"2020-03-30","NE","145","2584","5","0","2","2734","2729","31","0","0","616","37","653"
"2020-03-30","NH","314","5386","144","45","3","5844","5700","33","1","12","862","100","962"
"2020-03-30","NJ","16636","25224","0","0","198","41860","41860","34","37","0","3008","3250","6258"
"2020-03-30","NM","237","10942","0","0","2","11179","11179","35","0","0","173","0","173"
"2020-03-30","NV","1008","10207","0","0","15","11215","11215","32","1","0","1795","270","2065"
"2020-03-30","NY","66497","119971","0","13721","1218","186468","186468","36","253","1646","7124","6984","14108"
"2020-03-30","OH","1933","25342","0","475","39","27275","27275","39","10","72","6330","280","6610"
"2020-03-30","OK","481","1207","0","153","17","1688","1688","40","1","13","2","52","54"
"2020-03-30","OR","606","12277","0","140","16","12883","12883","41","3","11","1399","58","1457"
"2020-03-30","PA","4087","33777","0","386","49","37864","37864","42","11","33","3716","693","4409"
"2020-03-30","PR","174","931","794","0","6","1899","1105","72","1","0","90","47","137"
"2020-03-30","RI","402","3187","0","0","4","3589","3589","44","1","0","347","108","455"
"2020-03-30","SC","925","4160","0","102","18","5085","5085","45","2","0","1145","151","1296"
"2020-03-30","SD","101","3478","0","0","1","3579","3579","46","0","0","351","11","362"
"2020-03-30","TN","1834","21470","0","148","13","23304","23304","47","6","15","2433","297","2730"
"2020-03-30","TX","2877","33003","0","0","34","35880","35880","48","0","0","9795","325","10120"
"2020-03-30","UT","806","15197","0","0","4","16003","16003","49","2","0","1923","87","2010"
"2020-03-30","VA","1020","11018","0","136","25","12038","12038","51","3","24","1299","130","1429"
"2020-03-30","VI","30","126","24","0","0","180","156","78","0","0","3","7","10"
"2020-03-30","VT","256","3674","0","18","12","3930","3930","50","0","0","208","21","229"
"2020-03-30","WA","5589","74258","0","0","248","79847","79847","53","11","0","4470","468","4938"
"2020-03-30","WI","1221","15856","0","0","14","17077","17077","55","1","0","-694","109","-585"
"2020-03-30","WV","126","2984","0","1","1","3110","3110","54","1","0","279","13","292"
"2020-03-30","WY","94","1840","0","17","0","1934","1934","56","0","2","286","8","294"
"2020-03-29","AK","102","3232","0","6","2","3334","3334","02","0","1","396","17","413"
"2020-03-29","AL","806","4184","0","0","4","4990","4990","01","1","0","0","110","110"
"2020-03-29","AR","426","3027","0","0","6","3453","3453","05","1","0","89","22","111"
"2020-03-29","AS","0","0","0","0","0","0","0","60","0","0","0","0","0"
"2020-03-29","AZ","919","12953","0","0","17","13872","13872","04","2","0","5498","46","5544"
"2020-03-29","CA","5708","20549","64400","0","123","90657","26257","06","22","0","0","1065","1065"
"2020-03-29","CO","2061","11215","0","274","44","13276","13276","08","13","35","1273","327","1600"
"2020-03-29","CT","1993","9907","0","0","34","11900","11900","09","7","0","2798","702","3500"
"2020-03-29","DC","342","2469","1","0","5","2812","2811","11","1","0","258","38","296"
"2020-03-29","DE","232","36","0","0","6","268","268","10","3","0","0","18","18"
"2020-03-29","FL","4246","39070","0","594","56","43316","43316","12","2","68","3704","483","4187"
"2020-03-29","GA","2651","9913","0","666","80","12564","12564","13","11","49","1228","285","1513"
"2020-03-29","GU","56","334","0","0","1","390","390","66","0","0","35","1","36"
"2020-03-29","HI","151","6849","0","12","0","7000","7000","15","0","4","2492","31","2523"
"2020-03-29","IA","336","5013","0","68","4","5349","5349","19","1","7","638","38","676"
"2020-03-29","ID","261","4021","0","36","5","4282","4282","16","1","11","679","31","710"
"2020-03-29","IL","4596","23166","0","0","65","27762","27762","17","18","0","1166","1105","2271"
"2020-03-29","IN","1514","8316","0","0","32","9830","9830","18","1","0","1141","282","1423"
"2020-03-29","KS","319","4194","0","55","6","4513","4513","20","1","28","523","58","581"
"2020-03-29","KY","394","5147","0","0","9","5541","5541","21","1","0","326","92","418"
"2020-03-29","LA","3540","24331","0","0","151","27871","27871","22","14","0","2485","225","2710"
"2020-03-29","MA","4856","34234","0","399","99","39090","39090","25","27","49","3319","698","4017"
"2020-03-29","MD","1239","12354","0","277","10","13593","13593","24","5","51","838","247","1085"
"2020-03-29","ME","253","3394","0","0","3","3647","3647","23","2","0","0","42","42"
"2020-03-29","MI","10010","15676","0","0","132","25686","25686","26","40","0","1493","723","2216"
"2020-03-29","MN","503","17154","0","75","9","17657","17657","27","4","18","1466","62","1528"
"2020-03-29","MO","838","11547","0","0","10","12385","12385","29","0","0","1465","0","1465"
"2020-03-29","MP","2","0","0","0","0","2","2","69","0","0","0","0","0"
"2020-03-29","MS","758","2560","0","235","14","3318","3318","28","1","16","0","95","95"
"2020-03-29","MT","154","4143","0","8","1","4297","4297","30","0","1","887","25","912"
"2020-03-29","NC","1040","17905","0","0","4","18945","18945","37","0","0","1313","105","1418"
"2020-03-29","ND","98","3355","0","17","1","3453","3453","38","0","1","546","15","561"
"2020-03-29","NE","108","1968","4","0","2","2080","2076","31","0","0","64","12","76"
"2020-03-29","NH","214","4524","285","33","2","5023","4738","33","0","3","868","27","895"
"2020-03-29","NJ","13386","22216","0","0","161","35602","35602","34","21","0","2830","2262","5092"
"2020-03-29","NM","237","10769","0","0","2","11006","11006","35","1","0","1573","46","1619"
"2020-03-29","NV","738","8412","0","0","14","9150","9150","32","4","0","511","117","628"
"2020-03-29","NY","59513","112847","0","12075","965","172360","172360","36","237","2021","9231","7195","16426"
"2020-03-29","OH","1653","19012","0","403","29","20665","20665","39","4","59","0","247","247"
"2020-03-29","OK","429","1205","0","140","16","1634","1634","40","1","14","25","52","77"
"2020-03-29","OR","548","10878","0","129","13","11426","11426","41","0","12","1185","69","1254"
"2020-03-29","PA","3394","30061","0","353","38","33455","33455","42","4","37","4807","643","5450"
"2020-03-29","PR","127","841","817","0","5","1785","968","72","2","0","102","27","129"
"2020-03-29","RI","294","2840","0","0","3","3134","3134","44","3","0","299","55","354"
"2020-03-29","SC","774","3015","0","102","16","3789","3789","45","3","0","607","235","842"
"2020-03-29","SD","90","3127","1","0","1","3218","3217","46","0","0","535","22","557"
"2020-03-29","TN","1537","19037","0","133","7","20574","20574","47","1","15","2072","164","2236"
"2020-03-29","TX","2552","23208","0","0","34","25760","25760","48","7","0","0","500","500"
"2020-03-29","UT","719","13274","0","0","2","13993","13993","49","0","0","2564","117","2681"
"2020-03-29","VA","890","9719","0","112","22","10609","10609","51","5","13","1292","151","1443"
"2020-03-29","VI","23","123","37","0","0","183","146","78","0","0","17","1","18"
"2020-03-29","VT","235","3466","0","18","12","3701","3701","50","0","0","1303","24","1327"
"2020-03-29","WA","5121","69788","0","0","237","74909","74909","53","17","0","1586","384","1970"
"2020-03-29","WI","1112","16550","0","0","13","17662","17662","55","0","0","1318","123","1441"
"2020-03-29","WV","113","2705","0","1","0","2818","2818","54","0","0","374","17","391"
"2020-03-29","WY","86","1554","0","15","0","1640","1640","56","0","1","79","4","83"
"2020-03-28","AK","85","2836","0","5","2","2921","2921","02","1","2","517","16","533"
"2020-03-28","AL","696","4184","0","0","3","4880","4880","01","0","0","0","109","109"
"2020-03-28","AR","404","2938","0","0","5","3342","3342","05","2","0","1393","23","1416"
"2020-03-28","AS","0","0","0","0","0","0","0","60","0","0","0","0","0"
"2020-03-28","AZ","873","7455","21","0","15","8349","8328","04","2","0","0","137","137"
"2020-03-28","CA","4643","20549","64400","0","101","89592","25192","06","23","0","3169","764","3933"
"2020-03-28","CO","1734","9942","0","239","31","11676","11676","08","7","55","1250","304","1554"
"2020-03-28","CT","1291","7109","0","0","27","8400","8400","09","0","0","0","0","0"
"2020-03-28","DC","304","2211","1","0","4","2516","2515","11","1","0","314","37","351"
"2020-03-28","DE","214","36","0","0","3","250","250","10","1","0","0","51","51"
"2020-03-28","FL","3763","35366","0","526","54","39129","39129","12","20","70","7180","998","8178"
"2020-03-28","GA","2366","8685","0","617","69","11051","11051","13","5","51","821","365","1186"
"2020-03-28","GU","55","299","0","0","1","354","354","66","0","0","0","4","4"
"2020-03-28","HI","120","4357","0","8","0","4477","4477","15","0","1","0","14","14"
"2020-03-28","IA","298","4375","0","61","3","4673","4673","19","0","11","635","63","698"
"2020-03-28","ID","230","3342","0","25","4","3572","3572","16","1","25","674","41","715"
"2020-03-28","IL","3491","22000","0","0","47","25491","25491","17","13","0","3484","465","3949"
"2020-03-28","IN","1232","7175","0","0","31","8407","8407","18","7","0","1220","251","1471"
"2020-03-28","KS","261","3671","0","27","5","3932","3932","20","1","0","442","59","501"
"2020-03-28","KY","302","4821","0","0","8","5123","5123","21","2","0","1053","54","1107"
"2020-03-28","LA","3315","21846","0","0","137","25161","25161","22","18","0","3233","569","3802"
"2020-03-28","MA","4158","30915","0","350","72","35073","35073","25","15","131","4671","1007","5678"
"2020-03-28","MD","992","11516","0","226","5","12508","12508","24","0","53","11422","218","11640"
"2020-03-28","ME","211","3394","0","0","1","3605","3605","23","0","0","0","43","43"
"2020-03-28","MI","9287","14183","0","0","92","23470","23470","26","0","0","1544","628","2172"
"2020-03-28","MN","441","15688","0","57","5","16129","16129","27","1","6","2083","43","2126"
"2020-03-28","MO","838","10082","0","0","10","10920","10920","29","2","0","9713","169","9882"
"2020-03-28","MP","2","0","0","0","0","2","2","69","0","0","0","2","2"
"2020-03-28","MS","663","2560","0","219","13","3223","3223","28","5","34","0","84","84"
"2020-03-28","MT","129","3256","0","7","1","3385","3385","30","1","0","666","21","687"
"2020-03-28","NC","935","16592","0","0","4","17527","17527","37","1","0","2219","172","2391"
"2020-03-28","ND","83","2809","0","16","1","2892","2892","38","1","3","382","18","400"
"2020-03-28","NE","96","1904","0","0","2","2000","2000","31","2","0","143","11","154"
"2020-03-28","NH","187","3656","296","30","2","4139","3843","33","1","5","261","29","290"
"2020-03-28","NJ","11124","19386","0","0","140","30510","30510","34","32","0","2839","2299","5138"
"2020-03-28","NM","191","9196","0","0","1","9387","9387","35","0","0","819","55","874"
"2020-03-28","NV","621","7901","0","0","10","8522","8522","32","0","0","1740","86","1826"
"2020-03-28","NY","52318","103616","0","10054","728","155934","155934","36","209","1528","2498","7683","10181"
"2020-03-28","OH","1406","19012","0","344","25","20418","20418","39","6","68","0","269","269"
"2020-03-28","OK","377","1180","0","126","15","1557","1557","40","7","21","96","55","151"
"2020-03-28","OR","479","9693","0","117","13","10172","10172","41","1","15","1183","65","1248"
"2020-03-28","PA","2751","25254","0","316","34","28005","28005","42","12","75","4238","533","4771"
"2020-03-28","PR","100","739","792","0","3","1631","839","72","0","0","220","21","241"
"2020-03-28","RI","239","2541","138","0","0","2918","2780","44","0","0","235","36","271"
"2020-03-28","SC","539","2408","0","102","13","2947","2947","45","4","0","101","83","184"
"2020-03-28","SD","68","2592","0","0","1","2660","2660","46","0","0","205","10","215"
"2020-03-28","TN","1373","16965","0","118","6","18338","18338","47","0","15","2077","170","2247"
"2020-03-28","TX","2052","23208","0","0","27","25260","25260","48","4","0","1273","321","1594"
"2020-03-28","UT","602","10710","0","0","2","11312","11312","49","0","0","1946","122","2068"
"2020-03-28","VA","739","8427","0","99","17","9166","9166","51","3","16","1694","135","1829"
"2020-03-28","VI","22","106","55","0","0","183","128","78","0","0","51","3","54"
"2020-03-28","VT","211","2163","0","18","12","2374","2374","50","2","0","86","27","113"
"2020-03-28","WA","4737","68202","0","0","220","72939","72939","53","21","0","2315","432","2747"
"2020-03-28","WI","989","15232","0","0","13","16221","16221","55","0","0","2092","147","2239"
"2020-03-28","WV","96","2331","6","1","0","2433","2427","54","0","0","552","20","572"
"2020-03-28","WY","82","1475","0","14","0","1557","1557","56","0","3","264","12","276"
"2020-03-27","AK","69","2319","13","3","1","2401","2388","02","0","0","518","10","528"
"2020-03-27","AL","587","4184","0","0","3","4771","4771","01","2","0","591","81","672"
"2020-03-27","AR","381","1545","0","0","3","1926","1926","05","0","0","41","46","87"
"2020-03-27","AS","0","0","0","0","0","0","0","60","0","0","0","0","0"
"2020-03-27","AZ","736","7455","30","0","13","8221","8191","04","5","0","7108","159","7267"
"2020-03-27","CA","3879","17380","57400","0","78","78659","21259","06","13","0","0","873","873"
"2020-03-27","CO","1430","8692","0","184","24","10122","10122","08","5","36","1714","344","2058"
"2020-03-27","CT","1291","7109","0","0","27","8400","8400","09","6","0","1484","279","1763"
"2020-03-27","DC","267","1897","2","0","3","2166","2164","11","0","0","271","36","307"
"2020-03-27","DE","163","36","0","0","2","199","199","10","1","0","0","33","33"
"2020-03-27","FL","2765","28186","1517","456","34","32468","30951","12","6","50","4445","410","4855"
"2020-03-27","GA","2001","7864","0","566","64","9865","9865","13","16","93","463","476","939"
"2020-03-27","GU","51","299","0","0","1","350","350","66","0","0","36","6","42"
"2020-03-27","HI","106","4357","0","7","0","4463","4463","15","0","2","0","11","11"
"2020-03-27","IA","235","3740","0","50","3","3975","3975","19","2","4","1162","56","1218"
"2020-03-27","ID","189","2668","0","0","3","2857","2857","16","3","0","603","66","669"
"2020-03-27","IL","3026","18516","0","0","34","21542","21542","17","8","0","4423","488","4911"
"2020-03-27","IN","981","5955","0","0","24","6936","6936","18","7","0","1949","336","2285"
"2020-03-27","KS","202","3229","0","27","4","3431","3431","20","1","27","360","34","394"
"2020-03-27","KY","248","3768","0","0","6","4016","4016","21","2","0","666","50","716"
"2020-03-27","LA","2746","18613","0","0","119","21359","21359","22","36","0","2889","441","3330"
"2020-03-27","MA","3151","26244","0","219","57","29395","29395","25","15","0","4917","833","5750"
"2020-03-27","MD","774","94","0","173","5","868","868","24","1","41","0","194","194"
"2020-03-27","ME","168","3394","0","0","1","3562","3562","23","1","0","0","13","13"
"2020-03-27","MI","8659","12639","0","0","92","21298","21298","26","32","0","2334","892","3226"
"2020-03-27","MN","398","13605","0","51","4","14003","14003","27","2","10","1001","52","1053"
"2020-03-27","MO","669","369","0","0","8","1038","1038","29","0","0","0","167","167"
"2020-03-27","MP","0","0","0","0","0","0","0","69","0","0","0","0","0"
"2020-03-27","MS","579","2560","0","185","8","3139","3139","28","2","35","269","94","363"
"2020-03-27","MT","108","2590","0","7","0","2698","2698","30","0","6","462","37","499"
"2020-03-27","NC","763","14373","0","0","3","15136","15136","37","1","0","2099","127","2226"
"2020-03-27","ND","65","2427","0","13","0","2492","2492","38","0","3","388","13","401"
"2020-03-27","NE","85","1761","0","0","0","1846","1846","31","0","0","177","12","189"
"2020-03-27","NH","158","3395","592","25","1","4145","3553","33","0","6","394","21","415"
"2020-03-27","NJ","8825","16547","0","0","108","25372","25372","34","27","0","2886","1949","4835"
"2020-03-27","NM","136","8377","0","0","1","8513","8513","35","0","0","696","24","720"
"2020-03-27","NV","535","6161","0","0","10","6696","6696","32","0","0","1464","115","1579"
"2020-03-27","NY","44635","101118","0","8526","519","145753","145753","36","134","1682","16272","7377","23649"
"2020-03-27","OH","1137","19012","0","276","19","20149","20149","39","4","53","2563","270","2833"
"2020-03-27","OK","322","1084","0","105","8","1406","1406","40","1","19","126","74","200"
"2020-03-27","OR","414","8510","0","102","12","8924","8924","41","1","12","1557","87","1644"
"2020-03-27","PA","2218","21016","0","241","22","23234","23234","42","6","241","4575","531","5106"
"2020-03-27","PR","79","519","334","0","3","932","598","72","1","0","142","15","157"
"2020-03-27","RI","203","2306","138","0","0","2647","2509","44","0","0","1044","38","1082"
"2020-03-27","SC","456","2307","0","102","9","2763","2763","45","0","0","0","0","0"
"2020-03-27","SD","58","2387","20","0","1","2465","2445","46","0","0","414","12","426"
"2020-03-27","TN","1203","14888","0","103","6","16091","16091","47","3","27","936","246","1182"
"2020-03-27","TX","1731","21935","0","0","23","23666","23666","48","5","0","1907","335","2242"
"2020-03-27","UT","480","8764","0","0","2","9244","9244","49","1","0","1456","78","1534"
"2020-03-27","VA","604","6733","0","83","14","7337","7337","51","1","18","1004","144","1148"
"2020-03-27","VI","19","55","2","0","0","76","74","78","0","0","0","2","2"
"2020-03-27","VT","184","2077","0","18","10","2261","2261","50","1","18","227","26","253"
"2020-03-27","WA","4305","65887","0","0","199","70192","70192","53","16","0","3900","483","4383"
"2020-03-27","WI","842","13140","0","0","13","13982","13982","55","5","0","1557","135","1692"
"2020-03-27","WV","76","1779","43","1","0","1898","1855","54","0","0","748","25","773"
"2020-03-27","WY","70","1211","0","11","0","1281","1281","56","0","11","159","17","176"
"2020-03-26","AK","59","1801","0","3","1","1860","1860","02","0","2","152","17","169"
"2020-03-26","AL","506","3593","0","0","1","4099","4099","01","1","0","1064","223","1287"
"2020-03-26","AR","335","1504","0","0","3","1839","1839","05","1","0","67","55","122"
"2020-03-26","AS","0","0","0","0","0","0","0","60","0","0","0","0","0"
"2020-03-26","AZ","577","347","33","0","8","957","924","04","2","0","24","127","151"
"2020-03-26","CA","3006","17380","57400","0","65","77786","20386","06","12","0","1459","651","2110"
"2020-03-26","CO","1086","6978","0","148","19","8064","8064","08","8","64","189","174","363"
"2020-03-26","CT","1012","5625","0","0","21","6637","6637","09","2","0","602","137","739"
"2020-03-26","DC","231","1626","1","0","3","1858","1857","11","1","0","203","48","251"
"2020-03-26","DE","130","36","0","0","1","166","166","10","1","0","0","15","15"
"2020-03-26","FL","2355","23741","1443","406","28","27539","26096","12","6","90","8367","673","9040"
"2020-03-26","GA","1525","7401","0","473","48","8926","8926","13","8","79","2469","278","2747"
"2020-03-26","GU","45","263","0","0","1","308","308","66","0","0","30","8","38"
"2020-03-26","HI","95","4357","0","5","0","4452","4452","15","0","-1","0","5","5"
"2020-03-26","IA","179","2578","0","46","1","2757","2757","19","0","10","0","34","34"
"2020-03-26","ID","123","2065","0","0","0","2188","2188","16","0","0","178","50","228"
"2020-03-26","IL","2538","14093","0","0","26","16631","16631","17","7","0","1749","673","2422"
"2020-03-26","IN","645","4006","0","0","17","4651","4651","18","3","0","1127","168","1295"
"2020-03-26","KS","168","2869","0","0","3","3037","3037","20","0","0","509","42","551"
"2020-03-26","KY","198","3102","0","0","4","3300","3300","21","0","0","237","41","278"
"2020-03-26","LA","2305","15724","0","0","83","18029","18029","22","18","0","6068","510","6578"
"2020-03-26","MA","2318","21327","0","219","42","23645","23645","25","9","116","3248","579","3827"
"2020-03-26","MD","580","94","0","132","4","674","674","24","0","132","0","157","157"
"2020-03-26","ME","155","3394","0","0","0","3549","3549","23","0","0","217","6","223"
"2020-03-26","MI","7767","10305","0","0","60","18072","18072","26","17","0","2768","707","3475"
"2020-03-26","MN","346","12604","0","41","2","12950","12950","27","1","6","1416","59","1475"
"2020-03-26","MO","502","369","0","0","8","871","871","29","0","0","0","146","146"
"2020-03-26","MP","0","0","0","0","0","0","0","69","0","0","0","0","0"
"2020-03-26","MS","485","2291","0","150","6","2776","2776","28","4","33","725","108","833"
"2020-03-26","MT","71","2128","0","1","0","2199","2199","30","0","1","180","18","198"
"2020-03-26","NC","636","12274","0","0","2","12910","12910","37","1","0","2289","132","2421"
"2020-03-26","ND","52","2039","0","10","0","2091","2091","38","0","2","305","13","318"
"2020-03-26","NE","73","1584","0","0","0","1657","1657","31","0","0","280","12","292"
"2020-03-26","NH","137","3001","712","19","1","3850","3138","33","0","6","645","29","674"
"2020-03-26","NJ","6876","13661","0","0","81","20537","20537","34","19","0","3209","2474","5683"
"2020-03-26","NM","112","7681","0","0","1","7793","7793","35","0","0","939","12","951"
"2020-03-26","NV","420","4697","0","0","10","5117","5117","32","4","0","446","99","545"
"2020-03-26","NY","37258","84846","0","6844","385","122104","122104","36","100","3039","12178","6447","18625"
"2020-03-26","OH","867","16449","0","223","15","17316","17316","39","5","41","2389","163","2552"
"2020-03-26","OK","248","958","0","86","7","1206","1206","40","2","27","153","84","237"
"2020-03-26","OR","327","6953","0","90","11","7280","7280","41","3","29","2603","118","2721"
"2020-03-26","PA","1687","16441","0","0","16","18128","18128","42","5","0","5248","560","5808"
"2020-03-26","PR","64","377","335","0","2","776","441","72","0","0","60","13","73"
"2020-03-26","RI","165","1262","181","0","0","1608","1427","44","0","0","0","33","33"
"2020-03-26","SC","456","2307","0","102","9","2763","2763","45","2","0","4","32","36"
"2020-03-26","SD","46","1973","125","0","1","2144","2019","46","0","0","1154","5","1159"
"2020-03-26","TN","957","13952","0","76","3","14909","14909","47","0","23","2940","173","3113"
"2020-03-26","TX","1396","20028","0","0","18","21424","21424","48","6","0","7508","422","7930"
"2020-03-26","UT","402","7308","0","0","1","7710","7710","49","0","0","817","56","873"
"2020-03-26","VA","460","5729","0","65","13","6189","6189","51","4","6","750","69","819"
"2020-03-26","VI","17","55","2","0","0","74","72","78","0","0","0","0","0"
"2020-03-26","VT","158","1850","0","0","9","2008","2008","50","1","0","261","35","296"
"2020-03-26","WA","3822","61987","0","0","183","65809","65809","53","24","0","4058","483","4541"
"2020-03-26","WI","707","11583","0","0","8","12290","12290","55","1","0","1494","122","1616"
"2020-03-26","WV","51","1031","19","1","0","1101","1082","54","0","0","272","12","284"
"2020-03-26","WY","53","1052","0","0","0","1105","1105","56","0","0","98","9","107"
"2020-03-25","AK","42","1649","0","1","1","1691","1691","02","1","1","663","6","669"
"2020-03-25","AL","283","2529","0","0","0","2812","2812","01","0","0","423","68","491"
"2020-03-25","AR","280","1437","0","0","2","1717","1717","05","2","0","490","62","552"
"2020-03-25","AS","0","0","0","0","0","0","0","60","0","0","0","0","0"
"2020-03-25","AZ","450","323","53","0","6","826","773","04","1","0","10","93","103"
"2020-03-25","CA","2355","15921","48600","0","53","66876","18276","06","13","0","2469","253","2722"
"2020-03-25","CO","912","6789","0","84","11","7701","7701","08","4","12","1285","192","1477"
"2020-03-25","CT","875","5023","0","0","19","5898","5898","09","7","0","341","257","598"
"2020-03-25","DC","183","1423","3","0","2","1609","1606","11","0","0","228","46","274"
"2020-03-25","DE","115","36","0","0","0","151","151","10","0","0","0","24","24"
"2020-03-25","FL","1682","15374","1233","316","22","18289","17056","12","4","57","2247","270","2517"
"2020-03-25","GA","1247","4932","0","394","40","6179","6179","13","8","394","474","221","695"
"2020-03-25","GU","37","233","0","0","1","270","270","66","0","0","32","5","37"
"2020-03-25","HI","90","4357","0","6","0","4447","4447","15","0","2","768","13","781"
"2020-03-25","IA","145","2578","0","36","1","2723","2723","19","1","9","263","21","284"
"2020-03-25","ID","73","1887","0","0","0","1960","1960","16","0","0","0","23","23"
"2020-03-25","IL","1865","12344","0","0","19","14209","14209","17","3","0","2410","330","2740"
"2020-03-25","IN","477","2879","0","1","14","3356","3356","18","2","0","313","112","425"
"2020-03-25","KS","126","2360","0","0","3","2486","2486","20","1","0","274","28","302"
"2020-03-25","KY","157","2865","0","0","4","3022","3022","21","0","0","1103","33","1136"
"2020-03-25","LA","1795","9656","0","0","65","11451","11451","22","19","0","2441","407","2848"
"2020-03-25","MA","1739","18079","0","103","33","19818","19818","25","7","9","5365","679","6044"
"2020-03-25","MD","423","94","0","0","4","517","517","24","1","0","0","74","74"
"2020-03-25","ME","149","3177","0","0","0","3326","3326","23","0","0","163","24","187"
"2020-03-25","MI","7060","7537","0","0","43","14597","14597","26","19","0","1741","619","2360"
"2020-03-25","MN","287","11188","0","35","1","11475","11475","27","0","14","5638","25","5663"
"2020-03-25","MO","356","369","0","0","8","725","725","29","5","0","0","173","173"
"2020-03-25","MP","0","0","0","0","0","0","0","69","0","0","0","0","0"
"2020-03-25","MS","377","1566","0","117","2","1943","1943","28","1","31","14","57","71"
"2020-03-25","MT","53","1948","0","0","0","2001","2001","30","0","0","305","7","312"
"2020-03-25","NC","504","9985","0","0","1","10489","10489","37","1","0","1844","106","1950"
"2020-03-25","ND","39","1734","0","8","0","1773","1773","38","0","3","280","5","285"
"2020-03-25","NE","61","1304","0","0","0","1365","1365","31","0","0","329","9","338"
"2020-03-25","NH","108","2356","804","13","1","3268","2464","33","0","2","909","7","916"
"2020-03-25","NJ","4402","10452","0","0","62","14854","14854","34","18","0","2127","727","2854"
"2020-03-25","NM","100","6742","0","0","1","6842","6842","35","1","0","852","17","869"
"2020-03-25","NV","321","4251","0","0","6","4572","4572","32","2","0","297","43","340"
"2020-03-25","NY","30811","72668","0","3805","285","103479","103479","36","75","571","7063","5146","12209"
"2020-03-25","OH","704","14060","0","182","10","14764","14764","39","2","37","13920","140","14060"
"2020-03-25","OK","164","805","0","59","5","969","969","40","2","34","70","58","128"
"2020-03-25","OR","209","4350","0","61","8","4559","4559","41","0","0","0","0","0"
"2020-03-25","PA","1127","11193","0","0","11","12320","12320","42","4","0","2550","276","2826"
"2020-03-25","PR","51","317","70","0","2","438","368","72","0","0","49","12","61"
"2020-03-25","RI","132","1262","196","0","0","1590","1394","44","0","0","62","8","70"
"2020-03-25","SC","424","2303","0","102","7","2727","2727","45","2","102","291","126","417"
"2020-03-25","SD","41","819","268","0","1","1128","860","46","0","0","29","11","40"
"2020-03-25","TN","784","11012","0","53","3","11796","11796","47","1","53","495","117","612"
"2020-03-25","TX","974","12520","0","0","12","13494","13494","48","3","0","1763","564","2327"
"2020-03-25","UT","346","6491","0","0","1","6837","6837","49","0","0","967","47","1014"
"2020-03-25","VA","391","4979","0","59","9","5370","5370","51","2","14","799","101","900"
"2020-03-25","VI","17","55","2","0","0","74","72","78","0","0","55","0","55"
"2020-03-25","VT","123","1589","0","0","8","1712","1712","50","1","0","149","28","177"
"2020-03-25","WA","3339","57929","0","0","159","61268","61268","53","13","0","4588","462","5050"
"2020-03-25","WI","585","10089","0","0","7","10674","10674","55","2","0","1852","128","1980"
"2020-03-25","WV","39","759","6","1","0","804","798","54","0","0","149","19","168"
"2020-03-25","WY","44","954","0","0","0","998","998","56","0","0","244","15","259"
"2020-03-24","AK","36","986","0","0","0","1022","1022","02","0","0","40","14","54"
"2020-03-24","AL","215","2106","0","0","0","2321","2321","01","0","0","441","48","489"
"2020-03-24","AR","218","947","0","0","0","1165","1165","05","0","0","41","44","85"
"2020-03-24","AS","0","0","0","0","0","0","0","60","0","0","0","0","0"
"2020-03-24","AZ","357","313","22","0","5","692","670","04","3","0","4","92","96"
"2020-03-24","CA","2102","13452","12100","0","40","27654","15554","06","13","0","885","369","1254"
"2020-03-24","CO","720","5504","0","72","7","6224","6224","08","1","14","659","129","788"
"2020-03-24","CT","618","4682","0","0","12","5300","5300","09","2","0","597","203","800"
"2020-03-24","DC","137","1195","2","0","2","1334","1332","11","0","0","82","21","103"
"2020-03-24","DE","91","36","0","0","0","127","127","10","0","0","0","23","23"
"2020-03-24","FL","1412","13127","1008","259","18","15547","14539","12","4","42","2064","241","2305"
"2020-03-24","GA","1026","4458","0","0","32","5484","5484","13","7","0","161","254","415"
"2020-03-24","GU","32","201","0","0","1","233","233","66","0","0","40","3","43"
"2020-03-24","HI","77","3589","0","4","0","3666","3666","15","0","4","634","21","655"
"2020-03-24","IA","124","2315","0","27","0","2439","2439","19","0","27","272","19","291"
"2020-03-24","ID","50","1887","0","0","0","1937","1937","16","0","0","578","3","581"
"2020-03-24","IL","1535","9934","0","0","16","11469","11469","17","4","0","1351","262","1613"
"2020-03-24","IN","365","2566","0","1","12","2931","2931","18","5","0","865","106","971"
"2020-03-24","KS","98","2086","0","0","2","2184","2184","20","0","0","1669","16","1685"
"2020-03-24","KY","124","1762","0","0","4","1886","1886","21","1","0","0","20","20"
"2020-03-24","LA","1388","7215","0","0","46","8603","8603","22","12","0","2439","216","2655"
"2020-03-24","MA","1060","12714","0","94","26","13774","13774","25","9","15","4451","382","4833"
"2020-03-24","MD","349","94","0","0","3","443","443","24","0","0","0","61","61"
"2020-03-24","ME","125","3014","0","0","0","3139","3139","23","0","0","223","18","241"
"2020-03-24","MI","6441","5796","0","0","24","12237","12237","26","9","0","1099","652","1751"
"2020-03-24","MN","262","5550","0","21","1","5812","5812","27","0","4","1039","27","1066"
"2020-03-24","MO","183","369","0","0","3","552","552","29","0","0","0","0","0"
"2020-03-24","MP","0","0","0","0","0","0","0","69","0","0","0","0","0"
"2020-03-24","MS","320","1552","0","86","1","1872","1872","28","0","53","409","71","480"
"2020-03-24","MT","46","1643","0","0","0","1689","1689","30","0","0","497","12","509"
"2020-03-24","NC","398","8141","0","0","0","8539","8539","37","0","0","0","101","101"
"2020-03-24","ND","34","1454","0","5","0","1488","1488","38","0","1","101","4","105"
"2020-03-24","NE","52","975","0","0","0","1027","1027","31","0","0","619","2","621"
"2020-03-24","NH","101","1447","869","11","1","2417","1548","33","1","11","73","23","96"
"2020-03-24","NJ","3675","8325","45","0","44","12045","12000","34","17","0","7966","831","8797"
"2020-03-24","NM","83","5890","0","0","0","5973","5973","35","0","0","569","18","587"
"2020-03-24","NV","278","3954","0","0","4","4232","4232","32","0","0","464","33","497"
"2020-03-24","NY","25665","65605","0","3234","210","91270","91270","36","96","599","8191","4790","12981"
"2020-03-24","OH","564","140","0","145","8","704","704","39","2","41","0","122","122"
"2020-03-24","OK","106","735","0","25","3","841","841","40","1","10","41","25","66"
"2020-03-24","OR","209","4350","0","61","8","4559","4559","41","3","5","701","18","719"
"2020-03-24","PA","851","8643","0","0","7","9494","9494","42","1","0","2048","207","2255"
"2020-03-24","PR","39","268","42","0","2","349","307","72","0","0","79","8","87"
"2020-03-24","RI","124","1200","77","0","0","1401","1324","44","0","0","57","18","75"
"2020-03-24","SC","298","2012","0","0","5","2310","2310","45","0","0","546","0","546"
"2020-03-24","SD","30","790","268","0","1","1088","820","46","0","0","28","2","30"
"2020-03-24","TN","667","10517","0","0","2","11184","11184","47","0","0","7245","52","7297"
"2020-03-24","TX","410","10757","0","0","9","11167","11167","48","1","0","1054","58","1112"
"2020-03-24","UT","299","5524","0","0","1","5823","5823","49","0","0","734","42","776"
"2020-03-24","VA","290","4180","0","45","7","4470","4470","51","1","7","737","36","773"
"2020-03-24","VI","17","0","0","0","0","17","17","78","0","0","0","0","0"
"2020-03-24","VT","95","1440","0","0","7","1535","1535","50","2","0","334","20","354"
"2020-03-24","WA","2877","53341","0","0","146","56218","56218","53","9","0","4849","381","5230"
"2020-03-24","WI","457","8237","0","0","5","8694","8694","55","0","0","1187","41","1228"
"2020-03-24","WV","20","610","0","1","0","630","630","54","0","0","166","4","170"
"2020-03-24","WY","29","710","0","0","0","739","739","56","0","0","118","3","121"
"2020-03-23","AK","22","946","0","0","0","968","968","02","0","0","0","0","0"
"2020-03-23","AL","167","1665","0","0","0","1832","1832","01","0","0","201","29","230"
"2020-03-23","AR","174","906","0","0","0","1080","1080","05","0","0","195","9","204"
"2020-03-23","AS","0","0","0","0","0","0","0","60","0","0","0","0","0"
"2020-03-23","AZ","265","309","6","0","2","580","574","04","0","0","27","113","140"
"2020-03-23","CA","1733","12567","12100","0","27","26400","14300","06","0","0","1263","197","1460"
"2020-03-23","CO","591","4845","0","58","6","5436","5436","08","1","9","770","116","886"
"2020-03-23","CT","415","4085","0","0","10","4500","4500","09","5","0","1208","192","1400"
"2020-03-23","DC","116","1113","0","0","2","1229","1229","11","1","0","156","18","174"
"2020-03-23","DE","68","36","0","0","0","104","104","10","0","0","0","12","12"
"2020-03-23","FL","1171","11063","860","217","14","13094","12234","12","1","32","3073","341","3414"
"2020-03-23","GA","772","4297","0","0","25","5069","5069","13","2","0","877","172","1049"
"2020-03-23","GU","29","161","0","0","1","190","190","66","0","0","35","2","37"
"2020-03-23","HI","56","2955","0","0","0","3011","3011","15","0","0","2692","8","2700"
"2020-03-23","IA","105","2043","0","0","0","2148","2148","19","0","0","828","15","843"
"2020-03-23","ID","47","1309","0","0","0","1356","1356","16","0","0","134","5","139"
"2020-03-23","IL","1273","8583","0","0","12","9856","9856","17","3","0","1312","224","1536"
"2020-03-23","IN","259","1701","0","1","7","1960","1960","18","1","0","408","58","466"
"2020-03-23","KS","82","417","0","0","2","499","499","20","0","0","0","18","18"
"2020-03-23","KY","104","1762","0","0","3","1866","1866","21","0","0","290","5","295"
"2020-03-23","LA","1172","4776","0","0","34","5948","5948","22","14","0","2115","335","2450"
"2020-03-23","MA","678","8263","0","79","17","8941","8941","25","6","8","2787","131","2918"
"2020-03-23","MD","288","94","0","0","3","382","382","24","0","0","0","44","44"
"2020-03-23","ME","107","2791","0","0","0","2898","2898","23","0","0","527","18","545"
"2020-03-23","MI","5789","4697","0","0","15","10486","10486","26","7","0","985","691","1676"
"2020-03-23","MN","235","4511","0","17","1","4746","4746","27","0","5","0","66","66"
"2020-03-23","MO","183","369","0","0","3","552","552","29","0","0","0","93","93"
"2020-03-23","MP","0","0","0","0","0","0","0","69","0","0","0","0","0"
"2020-03-23","MS","249","1143","0","33","1","1392","1392","28","0","0","29","42","71"
"2020-03-23","MT","34","1146","0","0","0","1180","1180","30","0","0","0","3","3"
"2020-03-23","NC","297","8141","0","0","0","8438","8438","37","0","0","1958","42","2000"
"2020-03-23","ND","30","1353","0","4","0","1383","1383","38","0","1","93","2","95"
"2020-03-23","NE","50","356","0","0","0","406","406","31","0","0","0","2","2"
"2020-03-23","NH","78","1374","889","0","0","2341","1452","33","0","0","186","13","199"
"2020-03-23","NJ","2844","359","94","0","27","3297","3203","34","7","0","32","930","962"
"2020-03-23","NM","65","5321","0","0","0","5386","5386","35","0","0","599","8","607"
"2020-03-23","NV","245","3490","0","0","4","3735","3735","32","2","0","1042","55","1097"
"2020-03-23","NY","20875","57414","0","2635","114","78289","78289","36","0","661","11181","5707","16888"
"2020-03-23","OH","442","140","0","104","6","582","582","39","3","21","0","91","91"
"2020-03-23","OK","81","694","102","15","2","877","775","40","0","4","25","14","39"
"2020-03-23","OR","191","3649","0","56","5","3840","3840","41","1","13","785","30","815"
"2020-03-23","PA","644","6595","0","0","6","7239","7239","42","4","0","1631","165","1796"
"2020-03-23","PR","31","189","35","0","2","255","220","72","1","0","6","8","14"
"2020-03-23","RI","106","1143","216","0","0","1465","1249","44","0","0","211","23","234"
"2020-03-23","SC","298","1466","0","0","5","1764","1764","45","2","0","0","103","103"
"2020-03-23","SD","28","762","265","0","1","1055","790","46","0","0","22","7","29"
"2020-03-23","TN","615","3272","0","0","2","3887","3887","47","2","0","0","110","110"
"2020-03-23","TX","352","9703","0","0","8","10055","10055","48","3","0","1281","18","1299"
"2020-03-23","UT","257","4790","0","0","1","5047","5047","49","0","0","1282","76","1358"
"2020-03-23","VA","254","3443","0","38","6","3697","3697","51","3","6","325","35","360"
"2020-03-23","VI","17","0","0","0","0","17","17","78","0","0","0","11","11"
"2020-03-23","VT","75","1106","0","0","5","1181","1181","50","3","0","0","23","23"
"2020-03-23","WA","2496","48492","0","0","137","50988","50988","53","11","0","4852","212","5064"
"2020-03-23","WI","416","7050","0","0","5","7466","7466","55","1","0","820","31","851"
"2020-03-23","WV","16","444","4","1","0","464","460","54","0","0","59","4","63"
"2020-03-23","WY","26","592","0","0","0","618","618","56","0","0","154","2","156"
"2020-03-22","AK","22","946","0","0","0","968","968","02","0","0","188","8","196"
"2020-03-22","AL","138","1464","0","0","0","1602","1602","01","0","0","1436","14","1450"
"2020-03-22","AR","165","711","119","0","0","995","876","05","0","0","144","47","191"
"2020-03-22","AS","0","0","0","0","0","0","0","60","0","0","0","0","0"
"2020-03-22","AZ","152","282","87","0","2","521","434","04","1","0","42","48","90"
"2020-03-22","CA","1536","11304","0","0","27","12840","12840","06","3","0","55","257","312"
"2020-03-22","CO","475","4075","0","49","5","4550","4550","08","1","5","758","112","870"
"2020-03-22","CT","223","2877","0","0","5","3100","3100","09","1","0","771","29","800"
"2020-03-22","DC","98","957","0","0","1","1055","1055","11","0","0","451","21","472"
"2020-03-22","DE","56","36","0","0","0","92","92","10","0","0","0","11","11"
"2020-03-22","FL","830","7990","963","185","13","9783","8820","12","1","27","1411","172","1583"
"2020-03-22","GA","600","3420","0","0","23","4020","4020","13","9","0","863","93","956"
"2020-03-22","GU","27","126","0","0","1","153","153","66","1","0","18","12","30"
"2020-03-22","HI","48","263","0","0","0","311","311","15","0","0","139","11","150"
"2020-03-22","IA","90","1215","0","0","0","1305","1305","19","0","0","166","22","188"
"2020-03-22","ID","42","1175","0","0","0","1217","1217","16","0","0","295","11","306"
"2020-03-22","IL","1049","7271","0","0","9","8320","8320","17","3","0","1783","296","2079"
"2020-03-22","IN","201","1293","0","1","6","1494","1494","18","2","0","586","75","661"
"2020-03-22","KS","64","417","0","0","2","481","481","20","0","0","0","9","9"
"2020-03-22","KY","99","1472","0","0","3","1571","1571","21","1","0","758","45","803"
"2020-03-22","LA","837","2661","0","0","20","3498","3498","22","4","0","481","257","738"
"2020-03-22","MA","547","5476","0","71","11","6023","6023","25","4","10","677","121","798"
"2020-03-22","MD","244","94","0","0","3","338","338","24","1","0","0","54","54"
"2020-03-22","ME","89","2264","0","0","0","2353","2353","23","0","0","0","16","16"
"2020-03-22","MI","5098","3712","0","0","8","8810","8810","26","3","0","16","555","571"
"2020-03-22","MN","169","4511","0","12","1","4680","4680","27","0","12","559","31","590"
"2020-03-22","MO","90","369","0","0","3","459","459","29","0","0","0","17","17"
"2020-03-22","MP","0","0","0","0","0","0","0","69","0","0","0","0","0"
"2020-03-22","MS","207","1114","0","33","1","1321","1321","28","0","33","419","67","486"
"2020-03-22","MT","31","1146","0","0","0","1177","1177","30","0","0","0","11","11"
"2020-03-22","NC","255","6183","0","0","0","6438","6438","37","0","0","1091","71","1162"
"2020-03-22","ND","28","1260","0","3","0","1288","1288","38","0","0","119","0","119"
"2020-03-22","NE","48","356","0","0","0","404","404","31","0","0","0","10","10"
"2020-03-22","NH","65","1188","959","0","0","2212","1253","33","0","0","215","10","225"
"2020-03-22","NJ","1914","327","49","0","20","2290","2241","34","4","0","33","587","620"
"2020-03-22","NM","57","4722","0","0","0","4779","4779","35","0","0","951","0","951"
"2020-03-22","NV","190","2448","0","0","2","2638","2638","32","0","0","64","66","130"
"2020-03-22","NY","15168","46233","0","1974","114","61401","61401","36","70","371","11152","4812","15964"
"2020-03-22","OH","351","140","0","83","3","491","491","39","0","25","0","104","104"
"2020-03-22","OK","67","669","102","11","2","838","736","40","1","1","109","14","123"
"2020-03-22","OR","161","2864","0","43","4","3025","3025","41","1","43","861","47","908"
"2020-03-22","PA","479","4964","0","0","2","5443","5443","42","0","0","1198","108","1306"
"2020-03-22","PR","23","183","69","0","1","275","206","72","1","0","40","2","42"
"2020-03-22","RI","83","932","216","0","0","1231","1015","44","0","0","70","17","87"
"2020-03-22","SC","195","1466","0","0","3","1661","1661","45","2","0","211","43","254"
"2020-03-22","SD","21","740","277","0","1","1038","761","46","0","0","49","7","56"
"2020-03-22","TN","505","3272","0","0","0","3777","3777","47","0","0","0","134","134"
"2020-03-22","TX","334","8422","0","0","5","8756","8756","48","0","0","2204","30","2234"
"2020-03-22","UT","181","3508","0","0","1","3689","3689","49","1","0","1084","45","1129"
"2020-03-22","VA","219","3118","0","32","3","3337","3337","51","1","7","480","67","547"
"2020-03-22","VI","6","0","0","0","0","6","6","78","0","0","0","0","0"
"2020-03-22","VT","52","1106","0","0","2","1158","1158","50","0","0","327","23","350"
"2020-03-22","WA","2284","43640","0","0","126","45924","45924","53","15","0","1704","242","1946"
"2020-03-22","WI","385","6230","0","0","4","6615","6615","55","0","0","1602","104","1706"
"2020-03-22","WV","12","385","1","1","0","398","397","54","0","0","55","1","56"
"2020-03-22","WY","24","438","0","0","0","462","462","56","0","0","0","1","1"
"2020-03-21","AK","14","758","0","0","0","772","772","02","0","0","72","2","74"
"2020-03-21","AL","124","28","0","0","0","152","152","01","0","0","0","43","43"
"2020-03-21","AR","118","567","154","0","0","839","685","05","0","0","216","22","238"
"2020-03-21","AS","0","0","0","0","0","0","0","60","0","0","0","0","0"
"2020-03-21","AZ","104","240","122","0","1","466","344","04","1","0","29","39","68"
"2020-03-21","CA","1279","11249","0","0","24","12528","12528","06","4","0","825","216","1041"
"2020-03-21","CO","363","3317","0","44","4","3680","3680","08","1","44","642","86","728"
"2020-03-21","CT","194","2106","0","0","4","2300","2300","09","1","0","1502","0","1502"
"2020-03-21","DC","77","506","0","0","1","583","583","11","0","0","5","6","11"
"2020-03-21","DE","45","36","0","0","0","81","81","10","0","0","0","7","7"
"2020-03-21","FL","658","6579","1002","158","12","8239","7237","12","2","158","4709","138","4847"
"2020-03-21","GA","507","2557","0","0","14","3064","3064","13","1","0","591","87","678"
"2020-03-21","GU","15","108","0","0","0","123","123","66","0","0","22","1","23"
"2020-03-21","HI","37","124","0","0","0","161","161","15","0","0","0","11","11"
"2020-03-21","IA","68","1049","0","0","0","1117","1117","19","0","0","407","23","430"
"2020-03-21","ID","31","880","0","0","0","911","911","16","0","0","290","8","298"
"2020-03-21","IL","753","5488","0","0","6","6241","6241","17","1","0","1792","168","1960"
"2020-03-21","IN","126","707","0","1","4","833","833","18","2","1","232","47","279"
"2020-03-21","KS","55","417","0","0","2","472","472","20","1","0","0","11","11"
"2020-03-21","KY","54","714","0","0","2","768","768","21","1","0","122","7","129"
"2020-03-21","LA","580","2180","0","0","16","2760","2760","22","4","0","1612","107","1719"
"2020-03-21","MA","426","4799","0","61","7","5225","5225","25","2","61","1004","112","1116"
"2020-03-21","MD","190","94","0","0","2","284","284","24","1","0","0","41","41"
"2020-03-21","ME","73","2264","0","0","0","2337","2337","23","0","0","0","16","16"
"2020-03-21","MI","4543","3696","0","0","5","8239","8239","26","2","0","950","516","1466"
"2020-03-21","MN","138","3952","0","0","1","4090","4090","27","1","0","211","23","234"
"2020-03-21","MO","73","369","0","0","3","442","442","29","2","0","0","26","26"
"2020-03-21","MP","0","0","0","0","0","0","0","69","0","0","0","0","0"
"2020-03-21","MS","140","695","0","0","1","835","835","28","0","0","0","60","60"
"2020-03-21","MT","20","1146","0","0","0","1166","1166","30","0","0","215","4","219"
"2020-03-21","NC","184","5092","0","0","0","5276","5276","37","0","0","1996","47","2043"
"2020-03-21","ND","28","1141","0","3","0","1169","1169","38","0","3","341","8","349"
"2020-03-21","NE","38","356","0","0","0","394","394","31","0","0","116","6","122"
"2020-03-21","NH","55","973","942","0","0","1970","1028","33","0","0","228","11","239"
"2020-03-21","NJ","1327","294","40","0","16","1661","1621","34","5","0","30","437","467"
"2020-03-21","NM","57","3771","0","0","0","3828","3828","35","0","0","0","14","14"
"2020-03-21","NV","124","2384","0","0","2","2508","2508","32","1","0","392","15","407"
"2020-03-21","NY","10356","35081","0","1603","44","45437","45437","36","9","1603","9756","3254","13010"
"2020-03-21","OH","247","140","0","58","3","387","387","39","2","58","0","78","78"
"2020-03-21","OK","53","560","144","10","1","757","613","40","0","10","22","4","26"
"2020-03-21","OR","114","2003","433","0","3","2550","2117","41","0","0","0","0","0"
"2020-03-21","PA","371","3766","0","0","2","4137","4137","42","1","0","1192","103","1295"
"2020-03-21","PR","21","143","71","0","0","235","164","72","0","0","29","7","36"
"2020-03-21","RI","66","862","290","0","0","1218","928","44","0","0","62","12","74"
"2020-03-21","SC","152","1255","0","0","1","1407","1407","45","0","0","422","71","493"
"2020-03-21","SD","14","691","268","0","1","973","705","46","0","0","28","0","28"
"2020-03-21","TN","371","3272","0","0","0","3643","3643","47","0","0","2709","143","2852"
"2020-03-21","TX","304","6218","0","0","5","6522","6522","48","0","0","1135","110","1245"
"2020-03-21","UT","136","2424","0","0","0","2560","2560","49","0","0","389","24","413"
"2020-03-21","VA","152","2638","0","25","2","2790","2790","51","0","25","427","38","465"
"2020-03-21","VI","6","0","0","0","0","6","6","78","0","0","0","3","3"
"2020-03-21","VT","29","779","0","0","2","808","808","50","0","0","0","0","0"
"2020-03-21","WA","2042","41936","0","0","111","43978","43978","53","7","0","2108","238","2346"
"2020-03-21","WI","281","4628","0","0","4","4909","4909","55","1","0","1173","75","1248"
"2020-03-21","WV","11","330","2","1","0","343","341","54","0","1","111","4","115"
"2020-03-21","WY","23","438","0","0","0","461","461","56","0","0","107","4","111"
"2020-03-20","AK","12","686","0","0","0","698","698","02","0","0","254","6","260"
"2020-03-20","AL","81","28","0","0","0","109","109","01","0","0","0","13","13"
"2020-03-20","AR","96","351","203","0","0","650","447","05","0","0","41","50","91"
"2020-03-20","AS","0","0","0","0","0","0","0","60","0","0","0","0","0"
"2020-03-20","AZ","65","211","101","0","0","377","276","04","0","0","36","21","57"
"2020-03-20","CA","1063","10424","0","0","20","11487","11487","06","2","0","1637","139","1776"
"2020-03-20","CO","277","2675","0","0","3","2952","2952","08","1","0","563","61","624"
"2020-03-20","CT","194","604","0","0","3","798","798","09","2","0","0","98","98"
"2020-03-20","DC","71","501","1","0","1","573","572","11","1","0","348","32","380"
"2020-03-20","DE","38","36","0","0","0","74","74","10","0","0","0","8","8"
"2020-03-20","FL","520","1870","1026","0","10","3416","2390","12","2","0","337","130","467"
"2020-03-20","GA","420","1966","0","0","13","2386","2386","13","3","0","422","133","555"
"2020-03-20","GU","14","86","0","0","0","100","100","66","0","0","17","2","19"
"2020-03-20","HI","26","124","0","0","0","150","150","15","0","0","31","10","41"
"2020-03-20","IA","45","642","0","0","0","687","687","19","0","0","559","7","566"
"2020-03-20","ID","23","590","0","0","0","613","613","16","0","0","131","12","143"
"2020-03-20","IL","585","3696","0","0","5","4281","4281","17","1","0","971","163","1134"
"2020-03-20","IN","79","475","0","0","2","554","554","18","0","0","151","23","174"
"2020-03-20","KS","44","417","0","0","1","461","461","20","0","0","0","10","10"
"2020-03-20","KY","47","592","0","0","1","639","639","21","0","0","138","12","150"
"2020-03-20","LA","473","568","0","0","12","1041","1041","22","4","0","110","126","236"
"2020-03-20","MA","314","3795","0","0","5","4109","4109","25","2","0","877","85","962"
"2020-03-20","MD","149","94","0","0","1","243","243","24","0","0","0","42","42"
"2020-03-20","ME","57","2264","0","0","0","2321","2321","23","0","0","260","4","264"
"2020-03-20","MI","4027","2746","0","0","3","6773","6773","26","0","0","961","635","1596"
"2020-03-20","MN","115","3741","0","0","0","3856","3856","27","0","0","792","26","818"
"2020-03-20","MO","47","369","0","0","1","416","416","29","0","0","61","23","84"
"2020-03-20","MP","0","0","0","0","0","0","0","69","0","0","0","0","0"
"2020-03-20","MS","80","695","0","0","1","775","775","28","1","0","143","30","173"
"2020-03-20","MT","16","931","0","0","0","947","947","30","0","0","170","4","174"
"2020-03-20","NC","137","3096","0","0","0","3233","3233","37","0","0","688","40","728"
"2020-03-20","ND","20","800","0","0","0","820","820","38","0","0","307","5","312"
"2020-03-20","NE","32","240","0","0","0","272","272","31","0","0","0","5","5"
"2020-03-20","NH","44","745","631","0","0","1420","789","33","0","0","124","5","129"
"2020-03-20","NJ","890","264","86","0","11","1240","1154","34","2","0","54","148","202"
"2020-03-20","NM","43","3771","0","0","0","3814","3814","35","0","0","1009","8","1017"
"2020-03-20","NV","109","1992","0","0","1","2101","2101","32","0","0","366","14","380"
"2020-03-20","NY","7102","25325","0","0","35","32427","32427","36","23","0","7193","2950","10143"
"2020-03-20","OH","169","140","0","0","1","309","309","39","1","0","0","50","50"
"2020-03-20","OK","49","538","374","0","1","961","587","40","0","0","72","5","77"
"2020-03-20","OR","114","2003","433","0","3","2550","2117","41","0","0","674","26","700"
"2020-03-20","PA","268","2574","0","0","1","2842","2842","42","0","0","966","83","1049"
"2020-03-20","PR","14","114","52","0","0","180","128","72","0","0","58","9","67"
"2020-03-20","RI","54","800","140","0","0","994","854","44","0","0","146","10","156"
"2020-03-20","SC","81","833","0","0","1","914","914","45","0","0","250","21","271"
"2020-03-20","SD","14","663","270","0","1","947","677","46","0","0","112","3","115"
"2020-03-20","TN","228","563","0","0","0","791","791","47","0","0","214","74","288"
"2020-03-20","TX","194","5083","0","0","5","5277","5277","48","2","0","2871","51","2922"
"2020-03-20","UT","112","2035","0","0","0","2147","2147","49","0","0","587","34","621"
"2020-03-20","VA","114","2211","0","0","2","2325","2325","51","0","0","382","20","402"
"2020-03-20","VI","3","0","0","0","0","3","3","78","0","0","0","0","0"
"2020-03-20","VT","29","779","0","0","2","808","808","50","2","0","134","7","141"
"2020-03-20","WA","1804","39828","0","0","104","41632","41632","53","12","0","3768","241","4009"
"2020-03-20","WI","206","3455","0","0","3","3661","3661","55","3","0","1263","51","1314"
"2020-03-20","WV","7","219","13","0","0","239","226","54","0","0","76","5","81"
"2020-03-20","WY","19","331","0","0","0","350","350","56","0","0","60","1","61"
"2020-03-19","AK","6","432","0","0","0","438","438","02","0","0","26","0","26"
"2020-03-19","AL","68","28","0","0","0","96","96","01","0","0","0","22","22"
"2020-03-19","AR","46","310","113","0","0","469","356","05","0","0","74","13","87"
"2020-03-19","AS","0","0","0","0","0","0","0","60","0","0","0","0","0"
"2020-03-19","AZ","44","175","130","0","0","349","219","04","0","0","27","16","43"
"2020-03-19","CA","924","8787","0","0","18","9711","9711","06","5","0","806","313","1119"
"2020-03-19","CO","216","2112","0","0","2","2328","2328","08","0","0","495","33","528"
"2020-03-19","CT","96","604","0","0","1","700","700","09","1","0","479","28","507"
"2020-03-19","DC","39","153","11","0","0","203","192","11","0","0","15","8","23"
"2020-03-19","DE","30","36","0","0","0","66","66","10","0","0","0","5","5"
"2020-03-19","FL","390","1533","1019","0","8","2942","1923","12","1","0","308","76","384"
"2020-03-19","GA","287","1544","0","0","10","1831","1831","13","9","0","233","90","323"
"2020-03-19","GU","12","69","0","0","0","81","81","66","0","0","12","4","16"
"2020-03-19","HI","16","93","0","0","0","109","109","15","0","0","0","2","2"
"2020-03-19","IA","38","83","0","0","0","121","121","19","0","0","0","9","9"
"2020-03-19","ID","11","459","0","0","0","470","470","16","0","0","0","2","2"
"2020-03-19","IL","422","2725","0","0","4","3147","3147","17","3","0","962","134","1096"
"2020-03-19","IN","56","324","0","0","2","380","380","18","0","0","170","17","187"
"2020-03-19","KS","34","417","0","0","1","451","451","20","0","0","0","18","18"
"2020-03-19","KY","35","454","0","0","1","489","489","21","0","0","100","9","109"
"2020-03-19","LA","347","458","0","0","8","805","805","22","2","0","123","107","230"
"2020-03-19","MA","229","2918","0","0","3","3147","3147","25","1","0","803","73","876"
"2020-03-19","MD","107","94","0","0","1","201","201","24","1","0","0","22","22"
"2020-03-19","ME","53","2004","0","0","0","2057","2057","23","0","0","334","10","344"
"2020-03-19","MI","3392","1785","0","0","3","5177","5177","26","3","0","570","479","1049"
"2020-03-19","MN","89","2949","0","0","0","3038","3038","27","0","0","264","12","276"
"2020-03-19","MO","24","308","0","0","1","332","332","29","1","0","55","11","66"
"2020-03-19","MP","0","0","0","0","0","0","0","69","0","0","0","0","0"
"2020-03-19","MS","50","552","0","0","0","602","602","28","0","0","73","16","89"
"2020-03-19","MT","12","761","0","0","0","773","773","30","0","0","262","2","264"
"2020-03-19","NC","97","2408","0","0","0","2505","2505","37","0","0","621","34","655"
"2020-03-19","ND","15","493","0","0","0","508","508","38","0","0","225","9","234"
"2020-03-19","NE","27","240","0","0","0","267","267","31","0","0","34","3","37"
"2020-03-19","NH","39","621","231","0","0","891","660","33","0","0","108","13","121"
"2020-03-19","NJ","742","210","74","0","9","1026","952","34","4","0","20","315","335"
"2020-03-19","NM","35","2762","0","0","0","2797","2797","35","0","0","436","7","443"
"2020-03-19","NV","95","1626","0","0","1","1721","1721","32","0","0","1458","40","1498"
"2020-03-19","NY","4152","18132","0","0","12","22284","22284","36","0","0","5917","1770","7687"
"2020-03-19","OH","119","140","0","0","0","259","259","39","0","0","0","31","31"
"2020-03-19","OK","44","466","250","0","1","760","510","40","1","0","88","15","103"
"2020-03-19","OR","88","1329","437","0","3","1854","1417","41","0","0","211","13","224"
"2020-03-19","PA","185","1608","0","0","1","1793","1793","42","0","0","421","52","473"
"2020-03-19","PR","5","56","29","0","0","90","61","72","0","0","25","0","25"
"2020-03-19","RI","44","654","334","0","0","1032","698","44","0","0","114","11","125"
"2020-03-19","SC","60","583","0","0","1","643","643","45","0","0","0","0","0"
"2020-03-19","SD","11","551","385","0","1","947","562","46","0","0","0","0","0"
"2020-03-19","TN","154","349","0","0","0","503","503","47","0","0","0","56","56"
"2020-03-19","TX","143","2212","0","0","3","2355","2355","48","1","0","388","60","448"
"2020-03-19","UT","78","1448","0","0","0","1526","1526","49","0","0","1317","15","1332"
"2020-03-19","VA","94","1829","0","0","2","1923","1923","51","1","0","628","17","645"
"2020-03-19","VI","3","0","0","0","0","3","3","78","0","0","0","1","1"
"2020-03-19","VT","22","645","0","0","0","667","667","50","0","0","53","3","56"
"2020-03-19","WA","1563","36060","0","0","92","37623","37623","53","10","0","4218","149","4367"
"2020-03-19","WI","155","2192","0","0","0","2347","2347","55","0","0","615","49","664"
"2020-03-19","WV","2","143","3","0","0","148","145","54","0","0","21","1","22"
"2020-03-19","WY","18","271","0","0","0","289","289","56","0","0","93","3","96"
"2020-03-18","AK","6","406","0","0","0","412","412","02","0","0","72","3","75"
"2020-03-18","AL","46","28","0","0","0","74","74","01","0","0","0","10","10"
"2020-03-18","AR","33","236","50","0","0","319","269","05","0","0","39","11","50"
"2020-03-18","AS","0","0","0","0","0","0","0","60","0","0","0","0","0"
"2020-03-18","AZ","28","148","102","0","0","278","176","04","0","0","6","8","14"
"2020-03-18","CA","611","7981","0","0","13","8592","8592","06","2","0","0","128","128"
"2020-03-18","CO","183","1617","0","0","2","1800","1800","08","1","0","561","23","584"
"2020-03-18","CT","68","125","0","0","0","193","193","09","0","0","0","27","27"
"2020-03-18","DC","31","138","1","0","0","170","169","11","0","0","34","9","43"
"2020-03-18","DE","25","36","0","0","0","61","61","10","0","0","0","9","9"
"2020-03-18","FL","314","1225","954","0","7","2493","1539","12","1","0","285","128","413"
"2020-03-18","GA","197","1311","0","0","1","1508","1508","13","0","0","1311","51","1362"
"2020-03-18","GU","8","57","0","0","0","65","65","66","0","0","16","3","19"
"2020-03-18","HI","14","93","0","0","0","107","107","15","0","0","93","4","97"
"2020-03-18","IA","29","83","0","0","0","112","112","19","0","0","0","6","6"
"2020-03-18","ID","9","459","0","0","0","468","468","16","0","0","113","2","115"
"2020-03-18","IL","288","1763","0","0","1","2051","2051","17","0","0","423","129","552"
"2020-03-18","IN","39","154","0","0","2","193","193","18","0","0","25","9","34"
"2020-03-18","KS","16","417","0","0","1","433","433","20","0","0","35","1","36"
"2020-03-18","KY","26","354","0","0","1","380","380","21","0","0","59","4","63"
"2020-03-18","LA","240","335","0","0","6","575","575","22","2","0","49","103","152"
"2020-03-18","MA","156","2115","0","0","2","2271","2271","25","2","0","482","38","520"
"2020-03-18","MD","85","94","0","0","0","179","179","24","0","0","0","28","28"
"2020-03-18","ME","43","1670","0","0","0","1713","1713","23","0","0","367","11","378"
"2020-03-18","MI","2913","1215","0","0","0","4128","4128","26","0","0","589","520","1109"
"2020-03-18","MN","77","2685","0","0","0","2762","2762","27","0","0","409","17","426"
"2020-03-18","MO","13","253","0","0","0","266","266","29","0","0","46","5","51"
"2020-03-18","MP","0","0","0","0","0","0","0","69","0","0","0","0","0"
"2020-03-18","MS","34","479","0","0","0","513","513","28","0","0","111","13","124"
"2020-03-18","MT","10","499","0","0","0","509","509","30","0","0","196","2","198"
"2020-03-18","NC","63","1787","0","0","0","1850","1850","37","0","0","1313","23","1336"
"2020-03-18","ND","6","268","0","0","0","274","274","38","0","0","48","3","51"
"2020-03-18","NE","24","206","0","0","0","230","230","31","0","0","0","3","3"
"2020-03-18","NH","26","513","208","0","0","747","539","33","0","0","158","9","167"
"2020-03-18","NJ","427","190","21","0","5","638","617","34","2","0","27","160","187"
"2020-03-18","NM","28","2326","0","0","0","2354","2354","35","0","0","1077","5","1082"
"2020-03-18","NV","55","168","0","0","1","223","223","32","0","0","0","0","0"
"2020-03-18","NY","2382","12215","0","0","12","14597","14597","36","5","0","6709","682","7391"
"2020-03-18","OH","88","140","0","0","0","228","228","39","0","0","0","21","21"
"2020-03-18","OK","29","378","110","0","0","517","407","40","0","0","131","12","143"
"2020-03-18","OR","75","1118","361","0","3","1554","1193","41","3","0","429","28","457"
"2020-03-18","PA","133","1187","0","0","1","1320","1320","42","1","0","308","37","345"
"2020-03-18","PR","5","31","21","0","0","57","36","72","0","0","18","0","18"
"2020-03-18","RI","33","540","334","0","0","907","573","44","0","0","137","10","147"
"2020-03-18","SC","60","583","0","0","1","643","643","45","0","0","272","27","299"
"2020-03-18","SD","11","551","350","0","1","912","562","46","1","0","0","0","0"
"2020-03-18","TN","98","349","0","0","0","447","447","47","0","0","19","25","44"
"2020-03-18","TX","83","1824","0","0","2","1907","1907","48","1","0","620","19","639"
"2020-03-18","UT","63","131","0","0","0","194","194","49","0","0","0","12","12"
"2020-03-18","VA","77","1201","0","0","1","1278","1278","51","0","0","240","10","250"
"2020-03-18","VI","2","0","0","0","0","2","2","78","0","0","0","0","0"
"2020-03-18","VT","19","592","0","0","0","611","611","50","0","0","97","9","106"
"2020-03-18","WA","1414","31842","0","0","82","33256","33256","53","4","0","4474","174","4648"
"2020-03-18","WI","106","1577","0","0","0","1683","1683","55","0","0","539","34","573"
"2020-03-18","WV","1","122","14","0","0","137","123","54","0","0","42","1","43"
"2020-03-18","WY","15","178","0","0","0","193","193","56","0","0","83","5","88"
"2020-03-17","AK","3","334","0","0","0","337","337","02","0","0","191","2","193"
"2020-03-17","AL","36","28","0","0","0","64","64","01","0","0","0","8","8"
"2020-03-17","AR","22","197","41","0","0","260","219","05","0","0","65","0","65"
"2020-03-17","AS","0","0","0","0","0","0","0","60","0","0","0","0","0"
"2020-03-17","AZ","20","142","66","0","0","228","162","04","0","0","17","2","19"
"2020-03-17","CA","483","7981","0","0","11","8464","8464","06","5","0","0","148","148"
"2020-03-17","CO","160","1056","0","0","1","1216","1216","08","0","0","429","29","458"
"2020-03-17","CT","41","125","0","0","0","166","166","09","0","0","0","15","15"
"2020-03-17","DC","22","104","0","0","0","126","126","11","0","0","8","5","13"
"2020-03-17","DE","16","36","0","0","0","52","52","10","0","0","0","8","8"
"2020-03-17","FL","186","940","872","0","6","1998","1126","12","2","0","256","45","301"
"2020-03-17","GA","146","0","0","0","1","146","146","13","0","0","0","25","25"
"2020-03-17","GU","5","41","0","0","0","46","46","66","0","0","18","2","20"
"2020-03-17","HI","10","0","0","0","0","10","10","15","0","0","0","3","3"
"2020-03-17","IA","23","83","0","0","0","106","106","19","0","0","0","1","1"
"2020-03-17","ID","7","346","0","0","0","353","353","16","0","0","81","2","83"
"2020-03-17","IL","159","1340","0","0","1","1499","1499","17","1","0","408","66","474"
"2020-03-17","IN","30","129","0","0","2","159","159","18","1","0","14","6","20"
"2020-03-17","KS","15","382","0","0","1","397","397","20","0","0","216","4","220"
"2020-03-17","KY","22","295","0","0","1","317","317","21","0","0","61","1","62"
"2020-03-17","LA","137","286","0","0","4","423","423","22","2","0","98","22","120"
"2020-03-17","MA","118","1633","0","0","0","1751","1751","25","0","0","434","21","455"
"2020-03-17","MD","57","94","0","0","0","151","151","24","0","0","0","20","20"
"2020-03-17","ME","32","1303","0","0","0","1335","1335","23","0","0","539","15","554"
"2020-03-17","MI","2393","626","0","0","0","3019","3019","26","0","0","354","460","814"
"2020-03-17","MN","60","2276","0","0","0","2336","2336","27","0","0","437","6","443"
"2020-03-17","MO","8","207","0","0","0","215","215","29","0","0","43","2","45"
"2020-03-17","MP","0","0","0","0","0","0","0","69","0","0","0","0","0"
"2020-03-17","MS","21","368","0","0","0","389","389","28","0","0","91","9","100"
"2020-03-17","MT","8","303","0","0","0","311","311","30","0","0","105","1","106"
"2020-03-17","NC","40","474","0","0","0","514","514","37","0","0","178","7","185"
"2020-03-17","ND","3","220","0","0","0","223","223","38","0","0","97","2","99"
"2020-03-17","NE","21","206","0","0","0","227","227","31","0","0","36","3","39"
"2020-03-17","NH","17","355","195","0","0","567","372","33","0","0","84","4","88"
"2020-03-17","NJ","267","163","55","0","3","485","430","34","1","0","43","89","132"
"2020-03-17","NM","23","1249","0","0","0","1272","1272","35","0","0","683","6","689"
"2020-03-17","NV","55","168","0","0","1","223","223","32","0","0","0","10","10"
"2020-03-17","NY","1700","5506","0","0","7","7206","7206","36","0","0","963","750","1713"
"2020-03-17","OH","67","140","0","0","0","207","207","39","0","0","0","17","17"
"2020-03-17","OK","17","247","82","0","0","346","264","40","0","0","73","7","80"
"2020-03-17","OR","47","689","184","0","0","920","736","41","0","0","110","8","118"
"2020-03-17","PA","96","879","0","0","0","975","975","42","0","0","209","20","229"
"2020-03-17","PR","5","13","4","0","0","22","18","72","0","0","4","0","4"
"2020-03-17","RI","23","403","149","0","0","575","426","44","0","0","95","2","97"
"2020-03-17","SC","33","311","0","0","1","344","344","45","0","0","76","5","81"
"2020-03-17","SD","11","551","35","0","0","597","562","46","0","0","57","1","58"
"2020-03-17","TN","73","330","0","0","0","403","403","47","0","0","60","21","81"
"2020-03-17","TX","64","1204","0","0","1","1268","1268","48","1","0","1204","7","1211"
"2020-03-17","UT","51","131","0","0","0","182","182","49","0","0","0","12","12"
"2020-03-17","VA","67","961","0","0","1","1028","1028","51","0","0","523","16","539"
"2020-03-17","VI","2","0","0","0","0","2","2","78","0","0","0","1","1"
"2020-03-17","VT","10","495","0","0","0","505","505","50","0","0","74","2","76"
"2020-03-17","WA","1240","27368","0","0","78","28608","28608","53","9","0","4388","173","4561"
"2020-03-17","WI","72","1038","0","0","0","1110","1110","55","0","0","534","25","559"
"2020-03-17","WV","0","80","4","0","0","84","80","54","0","0","0","0","0"
"2020-03-17","WY","10","95","0","0","0","105","105","56","0","0","95","7","102"
"2020-03-16","AK","1","143","0","0","0","144","144","02","0","0","0","0","0"
"2020-03-16","AL","28","28","40","0","0","96","56","01","0","0","0","16","16"
"2020-03-16","AR","22","132","14","0","0","168","154","05","0","0","29","6","35"
"2020-03-16","AS","0","0","0","0","0","0","0","60","0","0","0","0","0"
"2020-03-16","AZ","18","125","63","0","0","206","143","04","0","0","4","6","10"
"2020-03-16","CA","335","7981","0","0","6","8316","8316","06","1","0","7065","42","7107"
"2020-03-16","CO","131","627","0","0","1","758","758","08","0","0","0","0","0"
"2020-03-16","CT","26","125","0","0","0","151","151","09","0","0","0","6","6"
"2020-03-16","DC","17","96","7","0","0","120","113","11","0","0","17","1","18"
"2020-03-16","DE","8","36","32","0","0","76","44","10","0","0","0","2","2"
"2020-03-16","FL","141","684","514","0","4","1339","825","12","0","0","6","25","31"
"2020-03-16","GA","121","0","0","0","1","121","121","13","0","0","0","22","22"
"2020-03-16","GU","3","23","0","0","0","26","26","66","0","0","0","0","0"
"2020-03-16","HI","7","0","0","0","0","7","7","15","0","0","0","5","5"
"2020-03-16","IA","22","83","0","0","0","105","105","19","0","0","0","4","4"
"2020-03-16","ID","5","265","0","0","0","270","270","16","0","0","91","0","91"
"2020-03-16","IL","93","932","0","0","0","1025","1025","17","0","0","483","29","512"
"2020-03-16","IN","24","115","0","0","1","139","139","18","1","0","13","5","18"
"2020-03-16","KS","11","166","0","0","1","177","177","20","0","0","31","3","34"
"2020-03-16","KY","21","234","0","0","1","255","255","21","1","0","95","5","100"
"2020-03-16","LA","115","188","0","0","2","303","303","22","0","0","32","25","57"
"2020-03-16","MA","97","1199","0","0","0","1296","1296","25","0","0","615","33","648"
"2020-03-16","MD","37","94","0","0","0","131","131","24","0","0","0","6","6"
"2020-03-16","ME","17","764","0","0","0","781","781","23","0","0","673","14","687"
"2020-03-16","MI","1933","272","30","0","0","2235","2205","26","0","0","67","453","520"
"2020-03-16","MN","54","1839","0","0","0","1893","1893","27","0","0","452","19","471"
"2020-03-16","MO","6","164","0","0","0","170","170","29","0","0","42","1","43"
"2020-03-16","MP","0","0","0","0","0","0","0","69","0","0","0","0","0"
"2020-03-16","MS","12","277","0","0","0","289","289","28","0","0","193","2","195"
"2020-03-16","MT","7","198","0","0","0","205","205","30","0","0","95","0","95"
"2020-03-16","NC","33","296","151","0","0","480","329","37","0","0","69","1","70"
"2020-03-16","ND","1","123","0","0","0","124","124","38","0","0","28","0","28"
"2020-03-16","NE","18","170","0","0","0","188","188","31","0","0","90","1","91"
"2020-03-16","NH","13","271","95","0","0","379","284","33","0","0","0","0","0"
"2020-03-16","NJ","178","120","20","0","2","318","298","34","0","0","0","80","80"
"2020-03-16","NM","17","566","0","0","0","583","583","35","0","0","84","4","88"
"2020-03-16","NV","45","168","0","0","1","213","213","32","1","0","0","24","24"
"2020-03-16","NY","950","4543","0","0","7","5493","5493","36","4","0","0","221","221"
"2020-03-16","OH","50","140","361","0","0","551","190","39","0","0","1","14","15"
"2020-03-16","OK","10","174","29","0","0","213","184","40","0","0","56","1","57"
"2020-03-16","OR","39","579","182","0","0","800","618","41","0","0","159","3","162"
"2020-03-16","PA","76","670","0","0","0","746","746","42","0","0","465","13","478"
"2020-03-16","PR","5","9","0","0","0","14","14","72","0","0","0","0","0"
"2020-03-16","RI","21","308","149","0","0","478","329","44","0","0","37","1","38"
"2020-03-16","SC","28","235","0","0","1","263","263","45","1","0","81","9","90"
"2020-03-16","SD","10","494","0","0","0","504","504","46","0","0","167","1","168"
"2020-03-16","TN","52","270","0","0","0","322","322","47","0","0","113","13","126"
"2020-03-16","TX","57","0","0","0","0","57","57","48","0","0","0","1","1"
"2020-03-16","UT","39","131","0","0","0","170","170","49","0","0","0","11","11"
"2020-03-16","VA","51","438","0","0","1","489","489","51","0","0","75","6","81"
"2020-03-16","VI","1","0","0","0","0","1","1","78","0","0","0","0","0"
"2020-03-16","VT","8","421","0","0","0","429","429","50","0","0","73","4","77"
"2020-03-16","WA","1067","22980","0","0","69","24047","24047","53","12","0","4608","128","4736"
"2020-03-16","WI","47","504","0","0","0","551","551","55","0","0","191","14","205"
"2020-03-16","WV","0","80","4","0","0","84","80","54","0","0","42","0","42"
"2020-03-16","WY","3","0","0","0","0","3","3","56","0","0","0","0","0"
"2020-03-15","AK","1","143","0","0","0","144","144","02","0","0","0","0","0"
"2020-03-15","AL","12","28","46","0","0","86","40","01","0","0","6","6","12"
"2020-03-15","AR","16","103","30","0","0","149","119","05","0","0","38","4","42"
"2020-03-15","AZ","12","121","50","0","0","183","133","04","0","0","0","0","0"
"2020-03-15","CA","293","916","0","0","5","1209","1209","06","0","0","0","41","41"
"2020-03-15","CO","131","627","0","0","1","758","758","08","0","0","17","30","47"
"2020-03-15","CT","20","125","0","0","0","145","145","09","0","0","0","9","9"
"2020-03-15","DC","16","79","20","0","0","115","95","11","0","0","30","6","36"
"2020-03-15","DE","6","36","32","0","0","74","42","10","0","0","0","0","0"
"2020-03-15","FL","116","678","454","0","4","1248","794","12","1","0","200","39","239"
"2020-03-15","GA","99","0","0","0","1","99","99","13","0","0","0","33","33"
"2020-03-15","HI","2","0","0","0","0","2","2","15","0","0","0","0","0"
"2020-03-15","IA","18","83","0","0","0","101","101","19","0","0","0","1","1"
"2020-03-15","ID","5","174","0","0","0","179","179","16","0","0","0","3","3"
"2020-03-15","IL","64","449","195","0","0","708","513","17","0","0","133","18","151"
"2020-03-15","IN","19","102","0","0","0","121","121","18","0","0","28","4","32"
"2020-03-15","KS","8","135","0","0","1","143","143","20","0","0","42","2","44"
"2020-03-15","KY","16","139","0","0","0","155","155","21","0","0","0","2","2"
"2020-03-15","LA","90","156","0","0","2","246","246","22","2","0","47","39","86"
"2020-03-15","MA","64","584","0","0","0","648","648","25","0","0","584","26","610"
"2020-03-15","MD","31","94","0","0","0","125","125","24","0","0","0","5","5"
"2020-03-15","ME","3","91","17","0","0","111","94","23","0","0","0","0","0"
"2020-03-15","MI","1480","205","26","0","0","1711","1685","26","0","0","0","284","284"
"2020-03-15","MN","35","1387","0","0","0","1422","1422","27","0","0","540","14","554"
"2020-03-15","MO","5","122","0","0","0","127","127","29","0","0","32","1","33"
"2020-03-15","MS","10","84","0","0","0","94","94","28","0","0","0","4","4"
"2020-03-15","MT","7","103","57","0","0","167","110","30","0","0","0","2","2"
"2020-03-15","NC","32","227","151","0","0","410","259","37","0","0","90","9","99"
"2020-03-15","ND","1","95","4","0","0","100","96","38","0","0","41","0","41"
"2020-03-15","NE","17","80","33","0","0","130","97","31","0","0","0","3","3"
"2020-03-15","NH","13","271","95","0","0","379","284","33","0","0","59","6","65"
"2020-03-15","NJ","98","120","34","0","2","252","218","34","1","0","23","48","71"
"2020-03-15","NM","13","482","0","0","0","495","495","35","0","0","245","3","248"
"2020-03-15","NV","21","168","164","0","0","353","189","32","0","0","0","1","1"
"2020-03-15","NY","729","4543","0","0","3","5272","5272","36","3","0","1764","205","1969"
"2020-03-15","OH","36","139","350","0","0","525","175","39","0","0","89","23","112"
"2020-03-15","OK","9","118","12","0","0","139","127","40","0","0","82","5","87"
"2020-03-15","OR","36","420","225","0","0","681","456","41","0","0","83","6","89"
"2020-03-15","PA","63","205","183","0","0","451","268","42","0","0","0","16","16"
"2020-03-15","RI","20","271","57","0","0","348","291","44","0","0","73","0","73"
"2020-03-15","SC","19","154","0","0","0","173","173","45","0","0","44","6","50"
"2020-03-15","SD","9","327","6","0","0","342","336","46","0","0","145","0","145"
"2020-03-15","TN","39","157","0","0","0","196","196","47","0","0","27","7","34"
"2020-03-15","TX","56","0","0","0","0","56","56","48","0","0","0","5","5"
"2020-03-15","UT","28","131","0","0","0","159","159","49","0","0","0","22","22"
"2020-03-15","VA","45","363","0","0","1","408","408","51","1","0","246","15","261"
"2020-03-15","VT","4","348","0","0","0","352","352","50","0","0","121","0","121"
"2020-03-15","WA","939","18372","0","0","57","19311","19311","53","6","0","1589","133","1722"
"2020-03-15","WI","33","313","0","0","0","346","346","55","0","0","144","14","158"
"2020-03-15","WV","0","38","1","0","0","39","38","54","0","0","12","0","12"
"2020-03-15","WY","3","0","0","0","0","3","3","56","0","0","0","1","1"
"2020-03-14","AK","1","143","0","0","0","144","144","02","0","0","84","0","84"
"2020-03-14","AL","6","22","46","0","0","74","28","01","0","0","11","5","16"
"2020-03-14","AR","12","65","26","0","0","103","77","05","0","0","35","3","38"
"2020-03-14","AZ","12","121","50","0","0","183","133","04","0","0","27","3","30"
"2020-03-14","CA","252","916","0","0","5","1168","1168","06","1","0","0","50","50"
"2020-03-14","CO","101","610","0","0","1","711","711","08","1","0","86","29","115"
"2020-03-14","CT","11","125","0","0","0","136","136","09","0","0","26","5","31"
"2020-03-14","DC","10","49","10","0","0","69","59","11","0","0","29","0","29"
"2020-03-14","DE","6","36","32","0","0","74","42","10","0","0","6","2","8"
"2020-03-14","FL","77","478","221","0","3","776","555","12","1","0","0","27","27"
"2020-03-14","GA","66","0","0","0","1","66","66","13","0","0","0","24","24"
"2020-03-14","HI","2","0","0","0","0","2","2","15","0","0","0","0","0"
"2020-03-14","IA","17","83","0","0","0","100","100","19","0","0","0","1","1"
"2020-03-14","ID","2","174","0","0","0","176","176","16","0","0","43","2","45"
"2020-03-14","IL","46","316","82","0","0","444","362","17","0","0","22","14","36"
"2020-03-14","IN","15","74","0","0","0","89","89","18","0","0","13","3","16"
"2020-03-14","KS","6","93","0","0","1","99","99","20","1","0","0","0","0"
"2020-03-14","KY","14","139","0","0","0","153","153","21","0","0","32","3","35"
"2020-03-14","LA","51","109","0","0","0","160","160","22","0","0","72","15","87"
"2020-03-14","MA","38","0","0","0","0","38","38","25","0","0","0","15","15"
"2020-03-14","MD","26","94","0","0","0","120","120","24","0","0","0","9","9"
"2020-03-14","ME","3","91","17","0","0","111","94","23","0","0","0","0","0"
"2020-03-14","MI","1196","205","26","0","0","1427","1401","26","0","0","72","251","323"
"2020-03-14","MN","21","847","0","0","0","868","868","27","0","0","306","7","313"
"2020-03-14","MO","4","90","0","0","0","94","94","29","0","0","19","2","21"
"2020-03-14","MS","6","84","0","0","0","90","90","28","0","0","43","2","45"
"2020-03-14","MT","5","103","0","0","0","108","108","30","0","0","48","4","52"
"2020-03-14","NC","23","137","0","0","0","160","160","37","0","0","51","8","59"
"2020-03-14","ND","1","54","14","0","0","69","55","38","0","0","15","0","15"
"2020-03-14","NE","14","80","33","0","0","127","94","31","0","0","0","1","1"
"2020-03-14","NH","7","212","31","0","0","250","219","33","0","0","118","1","119"
"2020-03-14","NJ","50","97","80","0","1","227","147","34","0","0","0","0","0"
"2020-03-14","NM","10","237","0","0","0","247","247","35","0","0","47","0","47"
"2020-03-14","NV","20","168","0","0","0","188","188","32","0","0","0","9","9"
"2020-03-14","NY","524","2779","0","0","0","3303","3303","36","0","0","0","103","103"
"2020-03-14","OH","13","50","159","0","0","222","63","39","0","0","0","0","0"
"2020-03-14","OK","4","36","37","0","0","77","40","40","0","0","0","1","1"
"2020-03-14","OR","30","337","157","0","0","524","367","41","0","0","0","0","0"
"2020-03-14","PA","47","205","150","0","0","402","252","42","0","0","65","6","71"
"2020-03-14","RI","20","198","57","0","0","275","218","44","0","0","56","6","62"
"2020-03-14","SC","13","110","0","0","0","123","123","45","0","0","35","1","36"
"2020-03-14","SD","9","182","3","0","0","194","191","46","0","0","109","0","109"
"2020-03-14","TN","32","130","0","0","0","162","162","47","0","0","14","6","20"
"2020-03-14","TX","51","0","0","0","0","51","51","48","0","0","0","12","12"
"2020-03-14","UT","6","131","0","0","0","137","137","49","0","0","0","0","0"
"2020-03-14","VA","30","117","0","0","0","147","147","51","0","0","0","0","0"
"2020-03-14","VT","4","227","0","0","0","231","231","50","0","0","85","2","87"
"2020-03-14","WA","806","16783","0","0","51","17589","17589","53","4","0","2185","104","2289"
"2020-03-14","WI","19","169","0","0","0","188","188","55","0","0","0","0","0"
"2020-03-14","WV","0","26","5","0","0","31","26","54","0","0","9","0","9"
"2020-03-14","WY","2","0","0","0","0","2","2","56","0","0","0","1","1"
"2020-03-13","AK","1","59","0","0","0","60","60","02","0","0","13","1","14"
"2020-03-13","AL","1","11","0","0","0","12","12","01","0","0","1","1","2"
"2020-03-13","AR","9","30","22","0","0","61","39","05","0","0","6","3","9"
"2020-03-13","AZ","9","94","40","0","0","143","103","04","0","0","12","0","12"
"2020-03-13","CA","202","916","0","0","4","1118","1118","06","0","0","0","0","0"
"2020-03-13","CO","72","524","0","0","0","596","596","08","0","0","226","27","253"
"2020-03-13","CT","6","99","0","0","0","105","105","09","0","0","10","0","10"
"2020-03-13","DC","10","20","0","0","0","30","30","11","0","0","0","0","0"
"2020-03-13","DE","4","30","10","0","0","44","34","10","0","0","7","0","7"
"2020-03-13","FL","50","478","221","0","2","749","528","12","0","0","177","18","195"
"2020-03-13","GA","42","0","0","0","1","42","42","13","1","0","0","11","11"
"2020-03-13","HI","2","0","0","0","0","2","2","15","0","0","0","0","0"
"2020-03-13","IA","16","83","29","0","0","128","99","19","0","0","16","2","18"
"2020-03-13","ID","0","131","0","0","0","131","131","16","0","0","38","0","38"
"2020-03-13","IL","32","294","92","0","0","418","326","17","0","0","28","7","35"
"2020-03-13","IN","12","61","0","0","0","73","73","18","0","0","9","0","9"
"2020-03-13","KS","6","93","0","0","0","99","99","20","0","0","52","2","54"
"2020-03-13","KY","11","107","0","0","0","118","118","21","0","0","51","3","54"
"2020-03-13","LA","36","37","0","0","0","73","73","22","0","0","0","22","22"
"2020-03-13","MA","23","0","0","0","0","23","23","25","0","0","0","15","15"
"2020-03-13","MD","17","94","0","0","0","111","111","24","0","0","0","5","5"
"2020-03-13","ME","3","91","17","0","0","111","94","23","0","0","26","2","28"
"2020-03-13","MI","945","133","26","0","0","1104","1078","26","0","0","42","243","285"
"2020-03-13","MN","14","541","0","0","0","555","555","27","0","0","234","5","239"
"2020-03-13","MO","2","71","0","0","0","73","73","29","0","0","7","1","8"
"2020-03-13","MS","4","41","0","0","0","45","45","28","0","0","0","3","3"
"2020-03-13","MT","1","55","0","0","0","56","56","30","0","0","21","0","21"
"2020-03-13","NC","15","86","0","0","0","101","101","37","0","0","26","3","29"
"2020-03-13","ND","1","39","12","0","0","52","40","38","0","0","27","0","27"
"2020-03-13","NE","13","80","33","0","0","126","93","31","0","0","0","3","3"
"2020-03-13","NH","6","94","21","0","0","121","100","33","0","0","0","0","0"
"2020-03-13","NJ","50","97","80","0","1","227","147","34","0","0","23","20","43"
"2020-03-13","NM","10","190","0","0","0","200","200","35","0","0","35","5","40"
"2020-03-13","NV","11","168","0","0","0","179","179","32","0","0","0","4","4"
"2020-03-13","NY","421","2779","0","0","0","3200","3200","36","0","0","2687","205","2892"
"2020-03-13","OH","13","50","159","0","0","222","63","39","0","0","20","8","28"
"2020-03-13","OK","3","36","37","0","0","76","39","40","0","0","0","0","0"
"2020-03-13","OR","30","337","157","0","0","524","367","41","0","0","51","11","62"
"2020-03-13","PA","41","140","130","0","0","311","181","42","0","0","24","19","43"
"2020-03-13","RI","14","142","29","0","0","185","156","44","0","0","48","9","57"
"2020-03-13","SC","12","75","0","0","0","87","87","45","0","0","27","2","29"
"2020-03-13","SD","9","73","11","0","0","93","82","46","0","0","46","1","47"
"2020-03-13","TN","26","116","0","0","0","142","142","47","0","0","37","8","45"
"2020-03-13","TX","39","0","0","0","0","39","39","48","0","0","0","16","16"
"2020-03-13","UT","6","131","0","0","0","137","137","49","0","0","0","2","2"
"2020-03-13","VA","30","117","0","0","0","147","147","51","0","0","0","13","13"
"2020-03-13","VT","2","142","0","0","0","144","144","50","0","0","45","0","45"
"2020-03-13","WA","702","14598","0","0","47","15300","15300","53","3","0","4027","151","4178"
"2020-03-13","WI","19","169","0","0","0","188","188","55","0","0","85","11","96"
"2020-03-13","WV","0","17","4","0","0","21","17","54","0","0","10","0","10"
"2020-03-13","WY","1","0","0","0","0","1","1","56","0","0","0","0","0"
"2020-03-12","AK","0","46","14","0","0","60","46","02","0","0","0","0","0"
"2020-03-12","AL","0","10","0","0","0","10","10","01","0","0","0","0","0"
"2020-03-12","AR","6","24","20","0","0","50","30","05","0","0","12","6","18"
"2020-03-12","AZ","9","82","24","0","0","115","91","04","0","0","23","0","23"
"2020-03-12","CA","202","916","0","0","4","1118","1118","06","4","0","0","45","45"
"2020-03-12","CO","45","298","0","0","0","343","343","08","0","0","47","17","64"
"2020-03-12","CT","6","89","0","0","0","95","95","09","0","0","18","3","21"
"2020-03-12","DC","10","20","0","0","0","30","30","11","0","0","0","5","5"
"2020-03-12","DE","4","23","14","0","0","41","27","10","0","0","6","3","9"
"2020-03-12","FL","32","301","147","0","2","480","333","12","0","0","0","4","4"
"2020-03-12","GA","31","0","0","0","0","31","31","13","0","0","0","9","9"
"2020-03-12","HI","2","0","0","0","0","2","2","15","0","0","0","0","0"
"2020-03-12","IA","14","67","24","0","0","105","81","19","0","0","21","1","22"
"2020-03-12","ID","0","93","0","0","0","93","93","16","0","0","26","0","26"
"2020-03-12","IL","25","266","76","0","0","367","291","17","0","0","22","6","28"
"2020-03-12","IN","12","52","0","0","0","64","64","18","0","0","19","2","21"
"2020-03-12","KS","4","41","0","0","0","45","45","20","0","0","0","3","3"
"2020-03-12","KY","8","56","0","0","0","64","64","21","0","0","10","0","10"
"2020-03-12","LA","14","37","0","0","0","51","51","22","0","0","0","8","8"
"2020-03-12","MA","8","0","0","0","0","8","8","25","0","0","0","0","0"
"2020-03-12","MD","12","94","0","0","0","106","106","24","0","0","0","3","3"
"2020-03-12","ME","1","65","20","0","0","86","66","23","0","0","23","1","24"
"2020-03-12","MI","702","91","27","0","0","820","793","26","0","0","34","205","239"
"2020-03-12","MN","9","307","0","0","0","316","316","27","0","0","90","4","94"
"2020-03-12","MO","1","64","0","0","0","65","65","29","0","0","64","0","64"
"2020-03-12","MS","1","41","0","0","0","42","42","28","0","0","21","1","22"
"2020-03-12","MT","1","34","0","0","0","35","35","30","0","0","13","1","14"
"2020-03-12","NC","12","60","0","0","0","72","72","37","0","0","60","5","65"
"2020-03-12","ND","1","12","14","0","0","27","13","38","0","0","5","1","6"
"2020-03-12","NE","10","80","33","0","0","123","90","31","0","0","33","5","38"
"2020-03-12","NH","6","94","21","0","0","121","100","33","0","0","56","2","58"
"2020-03-12","NJ","30","74","20","0","1","124","104","34","0","0","17","6","23"
"2020-03-12","NM","5","155","0","0","0","160","160","35","0","0","68","2","70"
"2020-03-12","NV","7","168","0","0","0","175","175","32","0","0","0","2","2"
"2020-03-12","NY","216","92","0","0","0","308","308","36","0","0","0","0","0"
"2020-03-12","OH","5","30","52","0","0","87","35","39","0","0","9","1","10"
"2020-03-12","OK","3","36","4","0","0","43","39","40","0","0","21","1","22"
"2020-03-12","OR","19","286","62","0","0","367","305","41","0","0","0","0","0"
"2020-03-12","PA","22","116","81","0","0","219","138","42","0","0","28","6","34"
"2020-03-12","RI","5","94","8","0","0","107","99","44","0","0","0","0","0"
"2020-03-12","SC","10","48","0","0","0","58","58","45","0","0","16","1","17"
"2020-03-12","SD","8","27","11","0","0","46","35","46","0","0","14","3","17"
"2020-03-12","TN","18","79","0","0","0","97","97","47","0","0","29","11","40"
"2020-03-12","TX","23","0","0","0","0","23","23","48","0","0","0","2","2"
"2020-03-12","UT","4","131","0","0","0","135","135","49","0","0","131","2","133"
"2020-03-12","VA","17","117","0","0","0","134","134","51","0","0","57","8","65"
"2020-03-12","VT","2","97","0","0","0","99","99","50","0","0","35","1","36"
"2020-03-12","WA","551","10571","0","0","44","11122","11122","53","4","0","3594","70","3664"
"2020-03-12","WI","8","84","0","0","0","92","92","55","0","0","41","5","46"
"2020-03-12","WV","0","7","1","0","0","8","7","54","0","0","4","0","4"
"2020-03-12","WY","1","0","0","0","0","1","1","56","0","0","0","1","1"
"2020-03-11","AK","0","46","14","0","0","60","46","02","0","0","23","0","23"
"2020-03-11","AL","0","10","0","0","0","10","10","01","0","0","10","0","10"
"2020-03-11","AR","0","12","14","0","0","26","12","05","0","0","0","0","0"
"2020-03-11","AZ","9","59","32","0","0","100","68","04","0","0","8","3","11"
"2020-03-11","CA","157","916","0","0","0","1073","1073","06","0","0","226","24","250"
"2020-03-11","CO","28","251","0","0","0","279","279","08","0","0","109","16","125"
"2020-03-11","CT","3","71","0","0","0","74","74","09","0","0","17","1","18"
"2020-03-11","DC","5","20","15","0","0","40","25","11","0","0","3","0","3"
"2020-03-11","DE","1","17","2","0","0","20","18","10","0","0","0","1","1"
"2020-03-11","FL","28","301","147","0","2","476","329","12","2","0","79","9","88"
"2020-03-11","GA","22","0","0","0","0","22","22","13","0","0","0","5","5"
"2020-03-11","HI","2","0","0","0","0","2","2","15","0","0","0","0","0"
"2020-03-11","IA","13","46","27","0","0","86","59","19","0","0","14","5","19"
"2020-03-11","ID","0","67","0","0","0","67","67","16","0","0","26","0","26"
"2020-03-11","IL","19","244","63","0","0","326","263","17","0","0","0","0","0"
"2020-03-11","IN","10","33","0","0","0","43","43","18","0","0","3","4","7"
"2020-03-11","KS","1","41","0","0","0","42","42","20","0","0","24","0","24"
"2020-03-11","KY","8","46","0","0","0","54","54","21","0","0","18","2","20"
"2020-03-11","LA","6","37","0","0","0","43","43","22","0","0","26","5","31"
"2020-03-11","MD","9","94","0","0","0","103","103","24","0","0","5","3","8"
"2020-03-11","ME","0","42","5","0","0","47","42","23","0","0","22","0","22"
"2020-03-11","MI","497","57","18","0","0","572","554","26","0","0","18","139","157"
"2020-03-11","MN","5","217","0","0","0","222","222","27","0","0","85","2","87"
"2020-03-11","MO","1","0","0","0","0","1","1","29","0","0","0","0","0"
"2020-03-11","MS","0","20","0","0","0","20","20","28","0","0","20","0","20"
"2020-03-11","MT","0","21","0","0","0","21","21","30","0","0","6","0","6"
"2020-03-11","NC","7","0","0","0","0","7","7","37","0","0","0","0","0"
"2020-03-11","ND","0","7","6","0","0","13","7","38","0","0","1","0","1"
"2020-03-11","NE","5","47","16","0","0","68","52","31","0","0","0","2","2"
"2020-03-11","NH","4","38","5","0","0","47","42","33","0","0","0","0","0"
"2020-03-11","NJ","24","57","20","0","1","101","81","34","1","0","13","9","22"
"2020-03-11","NM","3","87","0","0","0","90","90","35","0","0","18","3","21"
"2020-03-11","NV","5","168","0","0","0","173","173","32","0","0","154","4","158"
"2020-03-11","NY","216","92","0","0","0","308","308","36","0","0","0","43","43"
"2020-03-11","OH","4","21","24","0","0","49","25","39","0","0","7","1","8"
"2020-03-11","OK","2","15","11","0","0","28","17","40","0","0","0","0","0"
"2020-03-11","OR","19","286","62","0","0","367","305","41","0","0","73","4","77"
"2020-03-11","PA","16","88","54","0","0","158","104","42","0","0","88","4","92"
"2020-03-11","RI","5","94","24","0","0","123","99","44","0","0","36","2","38"
"2020-03-11","SC","9","32","0","0","0","41","41","45","0","0","8","2","10"
"2020-03-11","SD","5","13","2","0","0","20","18","46","0","0","2","5","7"
"2020-03-11","TN","7","50","0","0","0","57","57","47","0","0","50","0","50"
"2020-03-11","TX","21","0","0","0","0","21","21","48","0","0","0","8","8"
"2020-03-11","UT","2","0","0","0","0","2","2","49","0","0","0","0","0"
"2020-03-11","VA","9","60","0","0","0","69","69","51","0","0","7","1","8"
"2020-03-11","VT","1","62","0","0","0","63","63","50","0","0","22","0","22"
"2020-03-11","WA","481","6977","0","0","40","7458","7458","53","3","0","2127","84","2211"
"2020-03-11","WI","3","43","0","0","0","46","46","55","0","0","7","1","8"
"2020-03-11","WV","0","3","2","0","0","5","3","54","0","0","1","0","1"
"2020-03-11","WY","0","0","0","0","0","0","0","56","0","0","0","0","0"
"2020-03-10","AK","0","23","9","0","0","32","23","02","0","0","0","0","0"
"2020-03-10","AL","0","0","0","0","0","0","0","01","0","0","0","0","0"
"2020-03-10","AR","0","12","3","0","0","15","12","05","0","0","0","0","0"
"2020-03-10","AZ","6","51","27","0","0","84","57","04","0","0","7","1","8"
"2020-03-10","CA","133","690","0","0","0","823","823","06","0","0","0","19","19"
"2020-03-10","CO","12","142","1","0","0","155","154","08","0","0","9","3","12"
"2020-03-10","CT","2","54","0","0","0","56","56","09","0","0","8","1","9"
"2020-03-10","DC","5","17","2","0","0","24","22","11","0","0","3","4","7"
"2020-03-10","DE","0","17","3","0","0","20","17","10","0","0","2","0","2"
"2020-03-10","FL","19","222","155","0","0","396","241","12","0","0","82","1","83"
"2020-03-10","GA","17","0","0","0","0","17","17","13","0","0","0","5","5"
"2020-03-10","HI","2","0","0","0","0","2","2","15","0","0","0","0","0"
"2020-03-10","IA","8","32","11","0","0","51","40","19","0","0","6","5","11"
"2020-03-10","ID","0","41","0","0","0","41","41","16","0","0","0","0","0"
"2020-03-10","IL","19","244","63","0","0","326","263","17","0","0","53","12","65"
"2020-03-10","IN","6","30","0","0","0","36","36","18","0","0","30","4","34"
"2020-03-10","KS","1","17","21","0","0","39","18","20","0","0","6","0","6"
"2020-03-10","KY","6","28","0","0","0","34","34","21","0","0","11","2","13"
"2020-03-10","LA","1","11","0","0","0","12","12","22","0","0","6","0","6"
"2020-03-10","MD","6","89","0","0","0","95","95","24","0","0","16","1","17"
"2020-03-10","ME","0","20","5","0","0","25","20","23","0","0","19","0","19"
"2020-03-10","MI","358","39","24","0","0","421","397","26","0","0","3","104","107"
"2020-03-10","MN","3","132","0","0","0","135","135","27","0","0","52","1","53"
"2020-03-10","MO","1","0","0","0","0","1","1","29","0","0","0","0","0"
"2020-03-10","MS","0","0","0","0","0","0","0","28","0","0","0","0","0"
"2020-03-10","MT","0","15","0","0","0","15","15","30","0","0","4","0","4"
"2020-03-10","NC","7","0","0","0","0","7","7","37","0","0","0","5","5"
"2020-03-10","ND","0","6","2","0","0","8","6","38","0","0","6","0","6"
"2020-03-10","NE","3","47","16","0","0","66","50","31","0","0","11","0","11"
"2020-03-10","NH","4","38","5","0","0","47","42","33","0","0","0","0","0"
"2020-03-10","NJ","15","44","20","0","0","79","59","34","0","0","9","4","13"
"2020-03-10","NM","0","69","0","0","0","69","69","35","0","0","12","0","12"
"2020-03-10","NV","1","14","0","0","0","15","15","32","0","0","0","0","0"
"2020-03-10","NY","173","92","0","0","0","265","265","36","0","0","0","31","31"
"2020-03-10","OH","3","14","15","0","0","32","17","39","0","0","3","0","3"
"2020-03-10","OK","2","15","11","0","0","28","17","40","0","0","7","1","8"
"2020-03-10","OR","15","213","67","0","0","295","228","41","0","0","48","1","49"
"2020-03-10","PA","12","0","0","0","0","12","12","42","0","0","0","2","2"
"2020-03-10","RI","3","58","6","0","0","67","61","44","0","0","28","0","28"
"2020-03-10","SC","7","24","0","0","0","31","31","45","0","0","0","0","0"
"2020-03-10","SD","0","11","0","0","0","11","11","46","0","0","6","0","6"
"2020-03-10","TN","7","0","0","0","0","7","7","47","0","0","0","4","4"
"2020-03-10","TX","13","0","0","0","0","13","13","48","0","0","0","1","1"
"2020-03-10","UT","2","0","0","0","0","2","2","49","0","0","0","1","1"
"2020-03-10","VA","8","53","0","0","0","61","61","51","0","0","15","5","20"
"2020-03-10","VT","1","40","0","0","0","41","41","50","0","0","6","0","6"
"2020-03-10","WA","397","4850","0","0","37","5247","5247","53","2","0","1677","48","1725"
"2020-03-10","WI","2","36","0","0","0","38","38","55","0","0","0","1","1"
"2020-03-10","WV","0","2","3","0","0","5","2","54","0","0","0","0","0"
"2020-03-10","WY","0","0","0","0","0","0","0","56","0","0","0","0","0"
"2020-03-09","AK","0","23","9","0","0","32","23","02","0","0","9","0","9"
"2020-03-09","AL","0","0","0","0","0","0","0","01","0","0","0","0","0"
"2020-03-09","AR","0","12","0","0","0","12","12","05","0","0","6","0","6"
"2020-03-09","AZ","5","44","7","0","0","56","49","04","0","0","0","0","0"
"2020-03-09","CA","114","690","0","0","0","804","804","06","0","0","228","26","254"
"2020-03-09","CO","9","133","0","0","0","142","142","08","0","0","29","1","30"
"2020-03-09","CT","1","46","0","0","0","47","47","09","0","0","17","0","17"
"2020-03-09","DC","1","14","3","0","0","18","15","11","0","0","4","0","4"
"2020-03-09","DE","0","15","3","0","0","18","15","10","0","0","5","0","5"
"2020-03-09","FL","18","140","115","0","0","273","158","12","0","0","22","1","23"
"2020-03-09","GA","12","0","0","0","0","12","12","13","0","0","0","5","5"
"2020-03-09","HI","2","0","0","0","0","2","2","15","0","0","0","1","1"
"2020-03-09","IA","3","26","8","0","0","37","29","19","0","0","11","3","14"
"2020-03-09","ID","0","41","0","0","0","41","41","16","0","0","14","0","14"
"2020-03-09","IL","7","191","44","0","0","242","198","17","0","0","0","1","1"
"2020-03-09","IN","2","0","0","0","0","2","2","18","0","0","0","0","0"
"2020-03-09","KS","1","11","0","0","0","12","12","20","0","0","0","0","0"
"2020-03-09","KY","4","17","0","0","0","21","21","21","0","0","4","3","7"
"2020-03-09","LA","1","5","0","0","0","6","6","22","0","0","0","1","1"
"2020-03-09","MD","5","73","0","0","0","78","78","24","0","0","21","2","23"
"2020-03-09","ME","0","1","0","0","0","1","1","23","0","0","0","0","0"
"2020-03-09","MI","254","36","11","0","0","301","290","26","0","0","10","86","96"
"2020-03-09","MN","2","80","0","0","0","82","82","27","0","0","32","1","33"
"2020-03-09","MO","1","0","0","0","0","1","1","29","0","0","0","0","0"
"2020-03-09","MS","0","0","0","0","0","0","0","28","0","0","0","0","0"
"2020-03-09","MT","0","11","0","0","0","11","11","30","0","0","0","0","0"
"2020-03-09","NC","2","0","0","0","0","2","2","37","0","0","0","0","0"
"2020-03-09","ND","0","0","0","0","0","0","0","38","0","0","0","0","0"
"2020-03-09","NE","3","36","9","0","0","48","39","31","0","0","19","2","21"
"2020-03-09","NH","4","38","5","0","0","47","42","33","0","0","0","0","0"
"2020-03-09","NJ","11","35","14","0","0","60","46","34","0","0","4","5","9"
"2020-03-09","NM","0","57","0","0","0","57","57","35","0","0","9","0","9"
"2020-03-09","NV","1","14","0","0","0","15","15","32","0","0","0","0","0"
"2020-03-09","NY","142","92","0","0","0","234","234","36","0","0","0","37","37"
"2020-03-09","OH","3","11","5","0","0","19","14","39","0","0","1","3","4"
"2020-03-09","OK","1","8","10","0","0","19","9","40","0","0","0","0","0"
"2020-03-09","OR","14","165","52","0","0","231","179","41","0","0","65","0","65"
"2020-03-09","PA","10","0","0","0","0","10","10","42","0","0","0","4","4"
"2020-03-09","RI","3","30","6","0","0","39","33","44","0","0","0","0","0"
"2020-03-09","SC","7","24","0","0","0","31","31","45","0","0","16","5","21"
"2020-03-09","SD","0","5","0","0","0","5","5","46","0","0","0","0","0"
"2020-03-09","TN","3","0","0","0","0","3","3","47","0","0","0","0","0"
"2020-03-09","TX","12","0","0","0","0","12","12","48","0","0","0","4","4"
"2020-03-09","UT","1","0","0","0","0","1","1","49","0","0","0","0","0"
"2020-03-09","VA","3","38","9","0","0","50","41","51","0","0","2","1","3"
"2020-03-09","VT","1","34","0","0","0","35","35","50","0","0","6","0","6"
"2020-03-09","WA","349","3173","0","0","35","3522","3522","53","4","0","965","100","1065"
"2020-03-09","WI","1","36","0","0","0","37","37","55","0","0","5","0","5"
"2020-03-09","WV","0","2","3","0","0","5","2","54","0","0","0","0","0"
"2020-03-09","WY","0","0","0","0","0","0","0","56","0","0","0","0","0"
"2020-03-08","AK","0","14","6","0","0","20","14","02","0","0","2","0","2"
"2020-03-08","AL","0","0","0","0","0","0","0","01","0","0","0","0","0"
"2020-03-08","AR","0","6","0","0","0","6","6","05","0","0","0","0","0"
"2020-03-08","AZ","5","44","7","0","0","56","49","04","0","0","0","0","0"
"2020-03-08","CA","88","462","0","0","0","550","550","06","0","0","0","19","19"
"2020-03-08","CO","8","104","0","0","0","112","112","08","0","0","49","0","49"
"2020-03-08","CT","1","29","8","0","0","38","30","09","0","0","29","1","30"
"2020-03-08","DC","1","10","0","0","0","11","11","11","0","0","2","1","3"
"2020-03-08","DE","0","10","0","0","0","10","10","10","0","0","0","0","0"
"2020-03-08","FL","17","118","108","0","0","243","135","12","0","0","18","3","21"
"2020-03-08","GA","7","0","0","0","0","7","7","13","0","0","0","1","1"
"2020-03-08","HI","1","0","0","0","0","1","1","15","0","0","0","0","0"
"2020-03-08","IA","0","15","2","0","0","17","15","19","0","0","0","0","0"
"2020-03-08","ID","0","27","0","0","0","27","27","16","0","0","0","0","0"
"2020-03-08","IL","6","191","44","0","0","241","197","17","0","0","0","0","0"
"2020-03-08","IN","2","0","0","0","0","2","2","18","0","0","0","1","1"
"2020-03-08","KS","1","11","0","0","0","12","12","20","0","0","0","1","1"
"2020-03-08","KY","1","13","0","0","0","14","14","21","0","0","4","0","4"
"2020-03-08","LA","0","5","0","0","0","5","5","22","0","0","5","0","5"
"2020-03-08","MD","3","52","0","0","0","55","55","24","0","0","11","0","11"
"2020-03-08","ME","0","1","0","0","0","1","1","23","0","0","0","0","0"
"2020-03-08","MI","168","26","10","0","0","204","194","26","0","0","8","40","48"
"2020-03-08","MN","1","48","0","0","0","49","49","27","0","0","0","0","0"
"2020-03-08","MO","1","0","0","0","0","1","1","29","0","0","0","1","1"
"2020-03-08","MS","0","0","0","0","0","0","0","28","0","0","0","0","0"
"2020-03-08","MT","0","11","0","0","0","11","11","30","0","0","0","0","0"
"2020-03-08","NC","2","0","0","0","0","2","2","37","0","0","0","0","0"
"2020-03-08","ND","0","0","0","0","0","0","0","38","0","0","0","0","0"
"2020-03-08","NE","1","17","5","0","0","23","18","31","0","0","0","0","0"
"2020-03-08","NH","4","38","5","0","0","47","42","33","0","0","18","2","20"
"2020-03-08","NJ","6","31","0","0","0","37","37","34","0","0","31","2","33"
"2020-03-08","NM","0","48","0","0","0","48","48","35","0","0","0","0","0"
"2020-03-08","NV","1","14","0","0","0","15","15","32","0","0","0","0","0"
"2020-03-08","NY","105","92","0","0","0","197","197","36","0","0","0","29","29"
"2020-03-08","OH","0","10","4","0","0","14","10","39","0","0","1","0","1"
"2020-03-08","OK","1","8","2","0","0","11","9","40","0","0","8","0","8"
"2020-03-08","OR","14","100","53","0","0","167","114","41","0","0","23","7","30"
"2020-03-08","PA","6","0","0","0","0","6","6","42","0","0","0","2","2"
"2020-03-08","RI","3","30","12","0","0","45","33","44","0","0","0","1","1"
"2020-03-08","SC","2","8","0","0","0","10","10","45","0","0","0","0","0"
"2020-03-08","SD","0","5","0","0","0","5","5","46","0","0","0","0","0"
"2020-03-08","TN","3","0","0","0","0","3","3","47","0","0","0","2","2"
"2020-03-08","TX","8","0","0","0","0","8","8","48","0","0","0","0","0"
"2020-03-08","UT","1","0","0","0","0","1","1","49","0","0","0","0","0"
"2020-03-08","VA","2","36","6","0","0","44","38","51","0","0","5","2","7"
"2020-03-08","VT","1","28","0","0","0","29","29","50","0","0","12","1","13"
"2020-03-08","WA","249","2208","60","0","31","2517","2457","53","4","0","462","67","529"
"2020-03-08","WI","1","31","12","0","0","44","32","55","0","0","0","0","0"
"2020-03-08","WV","0","2","3","0","0","5","2","54","0","0","0","0","0"
"2020-03-08","WY","0","0","0","0","0","0","0","56","0","0","0","0","0"
"2020-03-07","AK","0","12","2","0","0","14","12","02","0","0","4","0","4"
"2020-03-07","AL","0","0","0","0","0","0","0","01","0","0","0","0","0"
"2020-03-07","AR","0","6","0","0","0","6","6","05","0","0","0","0","0"
"2020-03-07","AZ","5","44","7","0","0","56","49","04","0","0","11","2","13"
"2020-03-07","CA","69","462","0","0","0","531","531","06","0","0","0","9","9"
"2020-03-07","CO","8","55","69","0","0","132","63","08","0","0","9","6","15"
"2020-03-07","CT","0","0","0","0","0","0","0","09","0","0","0","0","0"
"2020-03-07","DC","0","8","1","0","0","9","8","11","0","0","0","0","0"
"2020-03-07","DE","0","10","0","0","0","10","10","10","0","0","0","0","0"
"2020-03-07","FL","14","100","88","0","0","202","114","12","0","0","45","5","50"
"2020-03-07","GA","6","0","0","0","0","6","6","13","0","0","0","4","4"
"2020-03-07","HI","1","0","0","0","0","1","1","15","0","0","0","0","0"
"2020-03-07","IA","0","15","2","0","0","17","15","19","0","0","0","0","0"
"2020-03-07","ID","0","27","0","0","0","27","27","16","0","0","0","0","0"
"2020-03-07","IL","6","191","44","0","0","241","197","17","0","0","11","1","12"
"2020-03-07","IN","1","0","0","0","0","1","1","18","0","0","0","0","0"
"2020-03-07","KS","0","11","2","0","0","13","11","20","0","0","7","0","7"
"2020-03-07","KY","1","9","0","0","0","10","10","21","0","0","2","1","3"
"2020-03-07","LA","0","0","0","0","0","0","0","22","0","0","0","0","0"
"2020-03-07","MD","3","41","0","0","0","44","44","24","0","0","15","0","15"
"2020-03-07","ME","0","1","0","0","0","1","1","23","0","0","0","0","0"
"2020-03-07","MI","128","18","9","0","0","155","146","26","0","0","10","30","40"
"2020-03-07","MN","1","48","0","0","0","49","49","27","0","0","12","1","13"
"2020-03-07","MO","0","0","0","0","0","0","0","29","0","0","0","0","0"
"2020-03-07","MS","0","0","0","0","0","0","0","28","0","0","0","0","0"
"2020-03-07","MT","0","11","0","0","0","11","11","30","0","0","0","0","0"
"2020-03-07","NC","2","0","0","0","0","2","2","37","0","0","0","0","0"
"2020-03-07","ND","0","0","0","0","0","0","0","38","0","0","0","0","0"
"2020-03-07","NE","1","17","5","0","0","23","18","31","0","0","0","1","1"
"2020-03-07","NH","2","20","3","0","0","25","22","33","0","0","0","0","0"
"2020-03-07","NJ","4","0","1","0","0","5","4","34","0","0","0","3","3"
"2020-03-07","NM","0","48","0","0","0","48","48","35","0","0","32","0","32"
"2020-03-07","NV","1","14","0","0","0","15","15","32","0","0","0","0","0"
"2020-03-07","NY","76","92","236","0","0","404","168","36","0","0","0","43","43"
"2020-03-07","OH","0","9","5","0","0","14","9","39","0","0","1","0","1"
"2020-03-07","OK","1","0","0","0","0","1","1","40","0","0","0","0","0"
"2020-03-07","OR","7","77","40","0","0","124","84","41","0","0","13","4","17"
"2020-03-07","PA","4","0","0","0","0","4","4","42","0","0","0","2","2"
"2020-03-07","RI","2","30","0","0","0","32","32","44","0","0","13","-1","12"
"2020-03-07","SC","2","8","0","0","0","10","10","45","0","0","3","2","5"
"2020-03-07","SD","0","5","0","0","0","5","5","46","0","0","0","0","0"
"2020-03-07","TN","1","0","0","0","0","1","1","47","0","0","0","0","0"
"2020-03-07","TX","8","0","0","0","0","8","8","48","0","0","0","3","3"
"2020-03-07","UT","1","0","0","0","0","1","1","49","0","0","0","0","0"
"2020-03-07","VA","0","31","7","0","0","38","31","51","0","0","10","0","10"
"2020-03-07","VT","0","16","0","0","0","16","16","50","0","0","8","0","8"
"2020-03-07","WA","182","1746","66","0","27","1994","1928","53","1","0","368","32","400"
"2020-03-07","WI","1","31","12","0","0","44","32","55","0","0","0","0","0"
"2020-03-07","WV","0","2","3","0","0","5","2","54","0","0","1","0","1"
"2020-03-07","WY","0","0","0","0","0","0","0","56","0","0","0","0","0"
"2020-03-06","AK","0","8","1","0","0","9","8","02","0","0","0","0","0"
"2020-03-06","AR","0","6","0","0","0","6","6","05","0","0","0","0","0"
"2020-03-06","AZ","3","33","15","0","0","51","36","04","0","0","5","1","6"
"2020-03-06","CA","60","462","0","0","0","522","522","06","0","0","0","7","7"
"2020-03-06","CO","2","46","30","0","0","78","48","08","0","0","27","2","29"
"2020-03-06","DC","0","8","1","0","0","9","8","11","0","0","2","0","2"
"2020-03-06","DE","0","10","0","0","0","10","10","10","0","0","0","0","0"
"2020-03-06","FL","9","55","51","0","0","115","64","12","0","0","24","0","24"
"2020-03-06","GA","2","0","0","0","0","2","2","13","0","0","0","0","0"
"2020-03-06","IA","0","15","2","0","0","17","15","19","0","0","0","0","0"
"2020-03-06","IL","5","180","35","0","0","220","185","17","0","0","15","0","15"
"2020-03-06","IN","1","0","0","0","0","1","1","18","0","0","0","0","0"
"2020-03-06","KS","0","4","0","0","0","4","4","20","0","0","0","0","0"
"2020-03-06","KY","0","7","3","0","0","10","7","21","0","0","0","0","0"
"2020-03-06","MD","3","26","12","0","0","41","29","24","0","0","9","3","12"
"2020-03-06","MI","98","8","8","0","0","114","106","26","0","0","0","26","26"
"2020-03-06","MN","0","36","0","0","0","36","36","27","0","0","0","0","0"
"2020-03-06","NC","2","0","0","0","0","2","2","37","0","0","0","1","1"
"2020-03-06","NE","0","17","5","0","0","22","17","31","0","0","0","0","0"
"2020-03-06","NH","2","20","3","0","0","25","22","33","0","0","4","0","4"
"2020-03-06","NJ","1","0","0","0","0","1","1","34","0","0","0","0","0"
"2020-03-06","NM","0","16","0","0","0","16","16","35","0","0","0","0","0"
"2020-03-06","NV","1","14","0","0","0","15","15","32","0","0","0","0","0"
"2020-03-06","NY","33","92","236","0","0","361","125","36","0","0","16","11","27"
"2020-03-06","OH","0","8","2","0","0","10","8","39","0","0","1","0","1"
"2020-03-06","OR","3","64","28","0","0","95","67","41","0","0","19","0","19"
"2020-03-06","PA","2","0","0","0","0","2","2","42","0","0","0","0","0"
"2020-03-06","RI","3","17","0","0","0","20","20","44","0","0","0","1","1"
"2020-03-06","SC","0","5","0","0","0","5","5","45","0","0","0","0","0"
"2020-03-06","TN","1","0","0","0","0","1","1","47","0","0","0","0","0"
"2020-03-06","TX","5","0","0","0","0","5","5","48","0","0","0","4","4"
"2020-03-06","VA","0","21","10","0","0","31","21","51","0","0","3","0","3"
"2020-03-06","VT","0","8","0","0","0","8","8","50","0","0","0","0","0"
"2020-03-06","WA","150","1378","0","0","26","1528","1528","53","6","0","435","53","488"
"2020-03-06","WI","1","31","12","0","0","44","32","55","0","0","12","0","12"
"2020-03-06","WV","0","1","4","0","0","5","1","54","0","0","0","0","0"
"2020-03-05","AZ","2","28","6","0","0","36","30","04","0","0","1","0","1"
"2020-03-05","CA","53","462","0","0","0","515","515","06","0","0","0","0","0"
"2020-03-05","CO","0","19","21","0","0","40","19","08","0","0","0","0","0"
"2020-03-05","DC","0","6","2","0","0","8","6","11","0","0","0","0","0"
"2020-03-05","FL","9","31","69","0","0","109","40","12","0","0","7","7","14"
"2020-03-05","GA","2","0","0","0","0","2","2","13","0","0","0","0","0"
"2020-03-05","IL","5","165","27","0","0","197","170","17","0","0","41","1","42"
"2020-03-05","MD","0","17","14","0","0","31","17","24","0","0","0","0","0"
"2020-03-05","MI","72","8","0","0","0","80","80","26","0","0","8","20","28"
"2020-03-05","NC","1","0","0","0","0","1","1","37","0","0","0","0","0"
"2020-03-05","NE","0","17","5","0","0","22","17","31","0","0","0","0","0"
"2020-03-05","NH","2","16","4","0","0","22","18","33","0","0","6","0","6"
"2020-03-05","NJ","1","0","0","0","0","1","1","34","0","0","0","0","0"
"2020-03-05","NV","1","14","0","0","0","15","15","32","0","0","0","0","0"
"2020-03-05","NY","22","76","24","0","0","122","98","36","0","0","28","16","44"
"2020-03-05","OH","0","7","3","0","0","10","7","39","0","0","0","0","0"
"2020-03-05","OR","3","45","13","0","0","61","48","41","0","0","16","0","16"
"2020-03-05","RI","2","17","0","0","0","19","19","44","0","0","6","0","6"
"2020-03-05","SC","0","5","0","0","0","5","5","45","0","0","0","0","0"
"2020-03-05","TN","1","0","0","0","0","1","1","47","0","0","0","0","0"
"2020-03-05","TX","1","0","0","0","0","1","1","48","0","0","0","0","0"
"2020-03-05","VA","0","18","3","0","0","21","18","51","0","0","0","0","0"
"2020-03-05","WA","97","943","0","0","20","1040","1040","53","4","0","312","21","333"
"2020-03-05","WI","1","19","6","0","0","26","20","55","0","0","0","0","0"
"2020-03-04","AZ","2","27","5","0","0","34","29","04","0","0","0","0","0"
"2020-03-04","CA","53","462","0","0","0","515","515","06","0","0","0","0","0"
"2020-03-04","FL","2","24","16","0","0","42","26","12","0","0","0","0","0"
"2020-03-04","GA","2","0","0","0","0","2","2","13","0","0","0","0","0"
"2020-03-04","IL","4","124","27","0","0","155","128","17","0","0","0","0","0"
"2020-03-04","MI","52","0","0","0","0","52","52","26","0","0","0","18","18"
"2020-03-04","NC","1","0","0","0","0","1","1","37","0","0","0","0","0"
"2020-03-04","NH","2","10","7","0","0","19","12","33","0","0","0","0","0"
"2020-03-04","NY","6","48","24","0","0","78","54","36","0","0","0","0","0"
"2020-03-04","OR","3","29","18","0","0","50","32","41","0","0","0","0","0"
"2020-03-04","RI","2","11","0","0","0","13","13","44","0","0","5","0","5"
"2020-03-04","SC","0","5","0","0","0","5","5","45","0","0","0","0","0"
"2020-03-04","TX","1","0","0","0","0","1","1","48","0","0","0","0","0"
"2020-03-04","WA","76","631","0","0","16","707","707","53","2","0","204","18","222"
"2020-03-04","WI","1","19","6","0","0","26","20","55","0","0","0","0","0"
"2020-03-03","MI","34","0","0","0","0","34","34","26","0","0","0","16","16"
"2020-03-03","RI","2","6","0","0","0","8","8","44","0","0","6","1","7"
"2020-03-03","WA","58","427","0","0","14","485","485","53","3","0","198","24","222"
"2020-03-02","MI","18","0","0","0","0","18","18","26","0","0","0","9","9"
"2020-03-02","RI","1","0","0","0","0","1","1","44","0","0","0","0","0"
"2020-03-02","WA","34","229","0","0","11","263","263","53","3","0","148","4","152"
"2020-03-01","MI","9","0","0","0","0","9","9","26","0","0","0","0","0"
"2020-03-01","RI","1","0","0","0","0","1","1","44","0","0","0","0","0"
"2020-03-01","WA","30","81","0","0","8","111","111","53","3","0","58","12","70"
"2020-02-29","WA","18","23","0","0","5","41","41","53","1","0","23","9","32"
"2020-02-28","WA","9","0","0","0","4","9","9","53","2","0","0","7","7"
"2020-02-27","WA","2","0","0","0","2","2","2","53","0","0","0","0","0"
"2020-02-26","WA","2","0","0","0","2","2","2","53","2","0","0","0","0"
"2020-02-25","WA","2","0","0","0","0","2","2","53","0","0","0","0","0"
"2020-02-24","WA","2","0","0","0","0","2","2","53","0","0","0","0","0"
"2020-02-23","WA","2","0","0","0","0","2","2","53","0","0","0","0","0"
"2020-02-22","WA","2","0","0","0","0","2","2","53","0","0","0","0","0"
"2020-02-21","WA","2","0","0","0","0","2","2","53","0","0","0","0","0"
"2020-02-20","WA","2","0","0","0","0","2","2","53","0","0","0","0","0"
"2020-02-19","WA","2","0","0","0","0","2","2","53","0","0","0","0","0"
"2020-02-18","WA","2","0","0","0","0","2","2","53","0","0","0","0","0"
"2020-02-17","WA","2","0","0","0","0","2","2","53","0","0","0","0","0"
"2020-02-16","WA","2","0","0","0","0","2","2","53","0","0","0","0","0"
"2020-02-15","WA","2","0","0","0","0","2","2","53","0","0","0","0","0"
"2020-02-14","WA","2","0","0","0","0","2","2","53","0","0","0","0","0"
"2020-02-13","WA","2","0","0","0","0","2","2","53","0","0","0","0","0"
"2020-02-12","WA","2","0","0","0","0","2","2","53","0","0","0","0","0"
"2020-02-11","WA","2","0","0","0","0","2","2","53","0","0","0","0","0"
"2020-02-10","WA","2","0","0","0","0","2","2","53","0","0","0","0","0"
"2020-02-09","WA","2","0","0","0","0","2","2","53","0","0","0","0","0"
"2020-02-08","WA","2","0","0","0","0","2","2","53","0","0","0","0","0"
"2020-02-07","WA","2","0","0","0","0","2","2","53","0","0","0","1","1"
"2020-02-06","WA","1","0","0","0","0","1","1","53","0","0","0","0","0"
"2020-02-05","WA","1","0","0","0","0","1","1","53","0","0","0","0","0"
"2020-02-04","WA","1","0","0","0","0","1","1","53","0","0","0","0","0"
"2020-02-03","WA","1","0","0","0","0","1","1","53","0","0","0","0","0"
"2020-02-02","WA","1","0","0","0","0","1","1","53","0","0","0","0","0"
"2020-02-01","WA","1","0","0","0","0","1","1","53","0","0","0","0","0"
"2020-01-31","WA","1","0","0","0","0","1","1","53","0","0","0","0","0"
"2020-01-30","WA","1","0","0","0","0","1","1","53","0","0","0","0","0"
"2020-01-29","WA","1","0","0","0","0","1","1","53","0","0","0","0","0"
"2020-01-28","WA","1","0","0","0","0","1","1","53","0","0","0","0","0"
"2020-01-27","WA","1","0","0","0","0","1","1","53","0","0","0","0","0"
"2020-01-26","WA","1","0","0","0","0","1","1","53","0","0","0","0","0"
"2020-01-25","WA","1","0","0","0","0","1","1","53","0","0","0","0","0"
"2020-01-24","WA","1","0","0","0","0","1","1","53","0","0","0","0","0"
"2020-01-23","WA","1","0","0","0","0","1","1","53","0","0","0","0","0"
"2020-01-22","WA","1","0","0","0","0","1","1","53","0","0","0","0","0"
